到	a
臦	aa
燛	aaow
匦	aaqt
臩	aasr
叵	ab
區	abbb
匰	abbf
毆	abbm
剾	abbn
歐	abbq
鷗	abbq
敺	abbv
甌	abby
尀	abgy
或	abk
匮	ablm
匜	acl
匠	aek
车	af
戒	af
輚	afaa
轟	afaa
輱	afab
軭	afah
轼	afaj
轾	afaj
軾	afaj
輊	afaj
轞	afam
轗	afap
軎	afb
辑	afbh
毄	afbm
轀	afbm
軦	afbq
轵	afbw
轺	afcb
轇	afce
軐	afcf
轫	afcy
轉	afdg
輏	afdk
轜	afds
辅	afdu
轌	afdv
椠	afed
堑	afej
斩	afek
蹔	afel
輴	afem
暂	afen
慙	afep
覱	afeq
磛	afes
輈	afeu
辀	afeu
錾	afew
軱	afex
轱	affb
轩	affl
轒	affm
轥	affr
輁	affw
轕	affw
軖	afh
輤	afhq
辏	afhs
轃	afht
輙	afhv
轊	afhv
辄	afhx
車	afii
輎	afiq
輄	afis
轖	afjb
辕	afjq
輘	afjt
转	afjv
転	afjx
轲	afkb
輕	afkj
輌	afkm
辐	afkn
軯	afku
辆	afkw
軘	afkx
輛	afky
轤	aflm
轳	aflv
輖	afmb
轘	afmq
軮	afms
輲	afms
撃	afmt
軗	afmv
軜	afmw
繋	afmx
軕	afmx
辋	afmy
輠	afnd
輰	afne
輫	afnf
轛	afng
輼	afnm
辒	afnm
轠	afnn
轴	afno
轐	afnu
輵	afnw
辊	afnx
軣	afo
轋	afpa
辖	afpb
軶	afpc
輐	afpq
輨	afpv
軝	afqa
軥	afqb
轹	afqi
輓	afqq
輣	afqq
輡	afqr
轨	afqt
軳	afqv
软	afqw
軧	afqy
輷	afqy
軵	afrg
輗	afrq
匶	afrr
匿	afsb
轭	afsc
轑	afsi
轣	afsl
輀	afsm
慝	afsp
輭	afss
軏	afsx
軑	afsy
軚	afsy
軷	afsy
轪	afsy
軞	afta
辂	aftb
輧	aftf
軠	aftj
轿	aftr
輹	aftt
轷	aftu
轶	aftw
轙	afua
輶	afud
軿	afuf
辚	afut
輑	afvb
轏	afvc
輮	afvd
轻	afvj
辗	afvq
轰	afvv
辍	afvv
輟	afvv
輍	afwb
轸	afwe
輪	afwf
辁	afwh
输	afwn
軨	afwp
轁	afwr
軡	afwv
轮	afwx
轧	afx
軋	afx
轚	afxa
軩	afxb
軪	afxc
檕	afxd
轈	afxd
轢	afxd
墼	afxj
蟿	afxl
辎	afxn
礊	afxs
擊	afxt
罊	afxt
繫	afxx
軴	afyh
輬	afyi
辌	afyi
辙	afyt
较	afyw
辘	afyx
七	ag
切	agco
袃	agcq
鸫	agiq
东	agiw
匡	ah
邼	ahc
劻	ahct
赜	ahmw
匤	ahy
臣	ai
匚	aiii
匯	airl
至	aj
臹	ajac
臸	ajaj
辕	ajbq
郅	ajc
臻	ajht
匞	ajl
匵	ajmm
到	ajng
鵄	ajqx
臶	ajsc
臵	ajtb
致	ajtw
牙	al
邪	alc
卧	alg
鸦	alqx
雅	alrl
匝	aml
匷	ammr
匪	anf
匣	anp
郾	anxc
匽	anxk
鶠	anxq
匾	apmf
蠶	aqal
朁	aqan
兓	aqaq
鬵	aqau
匢	aqe
匫	aqen
匹	aqg
兂	aqg
旡	aqg
朢	aqh
炁	aqow
鴄	aqqx
匛	aqy
戎	as
匲	asbb
翘	ascc
颐	asw
頣	asw
頤	asw
匧	asww
戈	at
盞	atam
虦	atam
剗	atan
戔	atat
戓	atb
臨	atbb
戜	atbh
或	atbk
盬	atbm
惑	atbp
成	atc
郕	atcc
盛	atcm
戒	atf
戊	atii
戋	atii
戌	atk
咸	atkb
烕	atko
感	atkp
觱	atkq
顑	atks
威	atkx
戚	atli
蹙	atll
鹽	atlm
慼	atlp
顣	atls
翳	atmc
醫	atmd
匴	atmf
瞖	atmm
贀	atmm
黳	atmm
盏	atmn
鷖	atmq
鹥	atmq
殹	atmv
毉	atmw
嫛	atmx
繄	atmx
瑿	atmy
划	atng
悘	atpu
医	ats
戎	ats
翘	atsc
尧	atsx
戉	atx
臧	atxa
戍	aty
監	atym
覧	atyq
覽	atyq
擥	atyt
鍳	atyw
鑒	atyw
譼	atyy
巨	av
乬	avcg
孯	avck
堅	avj
豎	avku
蜸	avl
螶	avll
賢	avmw
熙	avow
巸	avp
腎	avq
硻	avs
掔	avtg
巪	avv
鋻	avw
緊	avx
婜	avxk
媐	avxk
臤	avy
竪	avyu
匼	awb
匳	awbw
臥	awg
瓯	awky
殴	awmv
匬	awqn
欧	awqw
鸥	awqx
区	awy
匥	axf
匩	axh
匨	axsj
弋	ay
彧	ayek
甙	ayfj
弎	ayhg
弍	ayjg
式	ayjl
贰	ayjm
弌	ayk
匟	aymg
貣	aymw
忒	aypu
鸢	ayqx
隿	ayrl
中	b
嘔	babb
囀	badg
唓	baf
哐	bah
咥	baj
啭	bajv
喊	bakb
喴	bakx
呀	bal
嘁	bali
咂	baml
噆	baqn
哓	basx
嚂	batm
囕	batq
呕	bawy
吕	bb
吅	bb
嚚	bbab
嘓	bbak
品	bbb
鄵	bbbc
噪	bbbd
嘽	bbbf
喦	bbbm
嵒	bbbm
劋	bbbn
碞	bbbs
氉	bbbt
郘	bbc
哵	bbcn
咽	bbg
啯	bbhy
喌	bbir
噐	bbjb
鄂	bbjc
鹗	bbjq
颚	bbjs
咢	bbjx
呺	bbkx
串	bbl
哫	bbll
嘳	bblm
患	bblp
咒	bbmg
	bbmw
戰	bbna
嘼	bbnb
鄲	bbnc
單	bbnf
鼉	bbnp
囅	bbnq
鷤	bbnq
獸	bbns
辴	bbns
鼍	bbnx
斝	bbpf
嗯	bbpu
呪	bbqg
丳	bbr
器	bbsb
嚣	bbsb
嚻	bbsb
囂	bbsb
嚴	bbst
哭	bbsu
骂	bbv
駡	bbv
唈	bbvn
呮	bbw
嘂	bbxb
叩	bc
咖	bcb
呞	bcb
嗋	bccq
哪	bcjc
叼	bck
吇	bck
啊	bckb
吔	bcl
唨	bcmh
别	bcng
叨	bco
叧	bco
嚁	bcrl
另	bct
叻	bct
唌	bctl
嘐	bcwe
吼	bcx
吸	bcy
噿	bcyf
呆	bd
槑	bdbd
啉	bdd
噤	bddj
唽	bdek
喖	bdfb
哂	bdg
嘌	bdji
呠	bdk
唒	bdk
嘾	bdnf
喳	bdnk
嚯	bdrl
嚅	bdsm
哺	bdu
嘜	bdwt
唻	bdww
喓	bdxk
哘	beg
听	bek
嘥	bell
嗁	belm
嘚	beng
唙	beow
哌	beq
呱	bex
咕	bfb
啚	bfbb
鄙	bfbc
嚾	bfbr
嘆	bfbw
呓	bfcg
嘞	bfct
嘶	bfek
喷	bffm
叶	bfg
唭	bfh
咁	bfj
嚡	bfjj
囈	bfjx
嘩	bfkj
嗔	bfmw
唶	bfn
喵	bfnb
囆	bfnl
嘲	bfnq
嗼	bfns
噶	bfnw
噧	bfny
唠	bfpc
嚔	bfpl
嚏	bfpv
嗦	bfpx
囌	bfqt
嗬	bfrb
嚿	bfrr
嚄	bfrv
喏	bfsb
喃	bfu
囒	bfui
嚥	bfuo
吱	bfvy
哄	bfw
嗒	bfwb
嗏	bfwt
哎	bfwy
呭	bfx
啿	bfx
喋	bfxd
嚆	bfyb
因	bg
爴	bgae
國	bgak
回	bgb
圖	bgbb
圆	bgbm
囝	bgck
困	bgd
圑	bgdg
團	bgdg
圃	bgdu
哳	bgek
固	bgfb
团	bggt
団	bggy
囯	bgh
圊	bghq
国	bghy
囗	bgii
囦	bgio
围	bgjc
圔	bgjm
园	bgjq
囲	bgjr
圉	bgju
囩	bgjx
圄	bgkb
咑	bgkl
囸	bgkl
囤	bgkx
圜	bgmq
圌	bgms
圛	bgmu
圐	bgmy
囬	bgnj
恩	bgpu
囫	bgqe
欭	bgqw
啪	bgrn
囮	bgrx
圂	bgse
囨	bgsl
慁	bgsp
囿	bgsq
囷	bgtd
图	bgtu
圈	bguc
唞	bguf
圏	bguv
図	bguw
囙	bgv
囻	bgva
圕	bgvn
圍	bgvt
圇	bgwf
囚	bgwg
囶	bgwj
圙	bgwj
囧	bgwm
囹	bgwp
朙	bgwq
囵	bgwx
圀	bgwy
囼	bgxb
圞	bgxd
圗	bgxj
囡	bgxk
圎	bgxm
圝	bgxx
囜	bgxy
吋	bgy
圁	bgy
囥	bgym
啦	bgyu
呈	bh
戢	bhat
郢	bhc
囓	bhcl
喫	bhcs
噄	bhcx
咠	bhd
咡	bhd
哢	bhf
囁	bhhh
嚖	bhhp
嘒	bhhv
噖	bhhv
唪	bhjl
啧	bhmw
啨	bhq
嗪	bhtd
嚽	bhtm
嗷	bhtw
唛	bhtw
嗫	bhvv
嗉	bhx
口	bi
〇	biii
唦	biit
嘡	bij
唢	bimw
噹	binb
哨	biq
咣	bisx
吵	bit
嗨	bitx
啵	bivv
嘙	bivx
嚐	bixn
吐	bj
咭	bjb
嘻	bjbb
嘭	bjbe
嘟	bjc
哮	bjck
哋	bjcl
嘋	bjct
呩	bji
味	bjiw
哇	bjj
啩	bjjl
嘵	bjjs
叿	bjl
唝	bjmw
嗊	bjmw
啫	bjn
噎	bjpu
啈	bjuj
嚋	bjvg
唗	bjw
呋	bjwg
哧	bjwr
嚇	bjww
咾	bjx
嗑	bjxm
嗜	bjxn
呍	bjxy
呿	bjxy
呵	bkb
喇	bkbn
嗽	bkbq
囔	bkbq
嗝	bkbu
咞	bkf
吁	bkg
叮	bkl
吓	bklg
嘕	bklo
嘈	bkmn
唡	bkmw
啢	bkmy
囇	bkmy
哶	bknf
咧	bkng
咺	bknk
噁	bknp
哑	bknu
哽	bknw
呒	bksx
吴	bksy
呯	bkuk
唔	bkvb
啑	bkvl
咦	bkvw
啛	bkvx
号	bkx
號	bkxm
鴞	bkxq
鸮	bkxq
噸	bkxs
饕	bkxw
吨	bkxx
咓	bkxy
虽	bl
中	bl
踐	blaa
跮	blaj
跷	blas
践	blat
距	blav
呫	blb
躁	blbd
踀	blbl
蹪	blbm
噳	blbs
跏	blcb
跥	blcd
蹘	blce
躍	blcr
踺	blcv
趿	blcy
跴	bldg
蹅	bldk
蹮	bldv
蹝	blel
蹤	blel
踬	blem
跅	bley
跍	blfb
蹃	blfb
蹀	blfd
踑	blfh
躇	blfj
蹛	blfm
踖	blfn
躤	blfn
躏	blfr
跂	blfv
蹒	blfw
跇	blfx
踸	blfx
蹣	blfy
卟	blg
踌	blhg
躡	blhh
蹟	blhm
踳	blhn
蹖	blhr
蹑	blhv
踂	blhx
蹚	blij
踏	blin
踃	bliq
嚬	blis
踋	bljc
踍	bljc
跱	bljg
躊	bljg
跊	blji
跬	bljj
踷	bljn
蹺	bljs
踜	bljt
趺	bljw
嚱	blka
跒	blkb
趼	blkf
趶	blkg
踈	blki
踁	blkj
咔	blkl
贵	blkm
踾	blkn
蹧	blkn
囐	blks
跠	blkw
躎	blkw
躧	blky
足	bll
	bll
跕	bllb
踔	bllf
趾	blll
躆	blls
踄	bllt
踧	bllv
跐	bllx
踻	blmb
跺	blmd
唬	blmg
跙	blmh
跚	blmk
躅	blml
盅	blmn
蹦	blmq
躣	blmr
踹	blms
躩	blmv
蹋	blnc
踝	blnd
踢	blne
啅	blnf
蹕	blnj
踶	blnl
嚧	blnm
跩	blnt
嘘	blnu
蹼	blnu
噓	blnu
跳	bloq
躞	blov
蹥	blpa
踠	blpc
跹	blpf
蹁	blpf
踪	blpj
蹿	blpl
蹜	blpn
跶	blps
忠	blpu
蹆	blpv
躚	blpv
跎	blpx
啃	blq
跀	blq
跔	blqb
跪	blqc
跞	blqi
踭	blql
蹓	blqn
蹨	blqo
跢	blqq
踘	blqu
跑	blqv
趵	blqy
跗	blrg
踓	blrl
雖	blrl
躈	blrt
跖	bls
踎	blsb
踦	blsb
噱	blse
蹰	blsg
蹽	blsi
蹶	blsq
躘	blst
跨	blsx
跋	blsy
路	bltb
踟	bltb
蹻	bltb
趷	bltc
跦	blti
踵	bltj
躜	bltm
踿	blto
鹭	bltq
跣	bltq
鷺	bltq
跃	blts
跭	bltt
躌	bltt
嘑	bltu
跌	bltw
踇	bltx
踒	bltx
踽	blty
踯	bluc
跰	bluf
蹲	blug
躝	blui
蹉	bluj
蹭	blun
躙	blur
蹸	blut
躨	blut
噛	blux
跼	blvb
蹫	blvb
踴	blvc
蹂	blvd
踞	blvf
踊	blvm
跁	blvn
跽	blvp
跟	blvq
蹬	blvu
跛	blvv
趹	blvw
跜	blvx
躃	blvy
趴	blw
啮	blw
嚙	blw
跲	blwb
蹌	blwb
跄	blwc
踩	blwd
跈	blwe
踚	blwf
跧	blwh
踨	blwl
蹯	blwn
跉	blwp
踗	blwp
蹈	blwr
蹊	blws
趻	blwv
呲	blx
跆	blxb
喍	blxd
躒	blxd
跸	blxf
蹡	blxg
躖	blxk
躀	blxm
嘴	blxq
蹞	blxs
踆	blxt
躐	blxx
踮	blyb
踣	blyb
趽	blyc
踤	blyf
蹢	blyf
躕	blyg
跓	blyh
躔	blyj
蹄	blym
蹠	blyo
躟	blyq
跻	blyr
蹴	blys
蹾	blyt
踱	blyv
踉	blyv
跤	blyw
踥	blyx
蹗	blyx
员	bm
郧	bmc
鄖	bmc
勋	bmct
哚	bmd
嗣	bmfc
噥	bmfs
唺	bmfw
叽	bmg
咀	bmh
員	bmii
呥	bmj
嚜	bmj
啁	bmjb
哃	bmkb
噮	bmkq
吊	bml
嚸	bmlb
咄	bmm
嘪	bmmw
嘤	bmmx
呬	bmn
嘿	bmo
嗗	bmp
哯	bmqg
噣	bmql
嘣	bmqq
鶰	bmqx
啰	bmqy
嗺	bmrl
啱	bms
嘊	bmsj
喘	bmsm
咉	bmsy
吶	bmty
囎	bmun
吺	bmv
喎	bmvb
呗	bmw
唄	bmw
呐	bmwg
呙	bmwg
剐	bmwn
囉	bmxr
嗮	bndg
啡	bnf
嚗	bnfi
嗶	bnfj
哻	bnfl
嘬	bnhv
哩	bnj
嘢	bnjv
呾	bnk
啺	bnke
喂	bnkq
呻	bnl
嗢	bnmn
喁	bnmy
唱	bnn
呷	bnp
喟	bnq
喝	bnqw
嚉	bnug
噗	bnuh
黾	bnx
喅	bnyu
嘮	booc
啖	boow
咷	boqg
吙	bow
喗	bpaf
嗹	bpaf
呝	bpcg
噻	bpfj
啶	bpg
嗐	bphb
啌	bpjl
唍	bpjq
噠	bpju
喧	bpkk
咛	bpkl
嚃	bpmi
嚺	bpms
嚀	bppk
嘧	bppm
哝	bpq
啘	bpqc
嚓	bpqj
唳	bpsu
哒	bpsy
咇	bpt
咤	bpta
喀	bptb
哰	bptl
吣	bpu
嗵	bpvm
咜	bpx
咹	bpxk
噾	bpyn
肙	bq
呧	bqay
呴	bqb
嚵	bqby
嚠	bqcn
嘄	bqd
吻	bqe
唿	bqep
兄	bqg
噜	bqkn
瓹	bqky
唃	bqm
唤	bqms
咰	bqn
剈	bqng
呜	bqo
嗚	bqo
嚕	bqon
喣	bqow
焁	bqow
鹃	bqqx
哆	bqqy
啗	bqrj
嘫	bqso
噡	bqsy
啕	bqtm
呁	bqu
嘝	bquf
咆	bqv
喼	bqvp
吹	bqw
哅	bqwx
鸣	bqx
鳴	bqx
唣	brag
响	brb
呂	brb
嗰	brbf
咃	brcl
咻	brd
啤	brfg
咐	brgy
喤	brh
哬	brkb
唯	brl
咱	brm
嚊	brnr
嘷	brof
噑	brof
噍	brow
唲	brqg
鷕	brqx
啲	brqy
嗥	brsf
嗅	brsu
喺	brtx
噢	brus
喉	brvt
咿	brvt
嗖	brvy
吪	brx
喞	brxc
哗	brxf
噭	bryt
喕	bsbj
呃	bsc
呖	bsct
啄	bse
哤	bse
喯	bsff
嗕	bsgy
喹	bsjj
咗	bsjl
咵	bsjx
呸	bsk
吥	bsl
嘎	bsma
咘	bsml
嗄	bsmt
咟	bsn
喱	bsnj
嚈	bsns
唵	bsnx
咴	bsow
哊	bsq
喐	bsqc
咙	bst
嚨	bst
嚦	bstl
吠	bsu
嘹	bsui
噘	bsuq
唊	bsww
吰	bsxy
呔	bsy
吃	bt
吒	btag
哦	btat
咯	btb
啝	btb
啣	btc
吃	btcg
唀	btcp
咊	btd
呏	btf
吀	btfg
唾	btfk
嘸	btfo
喢	btfr
咮	btiw
哠	btj
噬	btjw
吘	btk
喠	btkj
嚑	btko
吽	btl
咋	btlg
喒	btln
嚹	btlu
咶	btm
囖	btmr
唎	btng
啾	btow
囋	btqm
嚟	btqw
嘺	btsb
哖	bttj
咚	btu
呼	btuk
呚	btw
呹	btwg
唩	btxk
叺	bty
喩	btyx
啳	buc
咪	bud
噂	budg
呌	bufg
咩	buh
嗟	bujl
吖	bul
噌	bumn
啴	bunf
哾	buq
嚪	buqr
噒	buqt
咲	busy
	buvt
	buvt
嗛	buw
嗌	buwm
唥	buwp
唴	bux
喽	buxk
嗍	buxq
嗞	buxx
嗴	buxx
吗	bv
嗎	bv
呡	bvag
喔	bvaj
嘅	bvaq
喡	bvbt
噼	bvby
唧	bvc
吜	bvf
啹	bvfb
噉	bvht
囑	bvil
啸	bvir
噚	bvjg
噔	bvku
吲	bvl
嚍	bvlm
嘯	bvlr
啒	bvmm
唰	bvmn
吧	bvn
邑	bvn
唚	bvpv
哏	bvq
咈	bvr
吚	bvt
噊	bvtb
嘱	bvty
嘨	bvur
嗓	bvvd
啜	bvvv
噀	bvvw
吷	bvwg
呢	bvx
叹	bvy
呎	bvy
只	bw
叭	bw
唫	bw
哈	bwb
噞	bwbw
呛	bwc
噏	bwcc
哹	bwck
吩	bwco
啂	bwcx
啋	bwd
嘦	bwdx
啽	bwf
哷	bwgy
哙	bwjx
喛	bwkv
嚼	bwmg
噲	bwmn
噃	bwn
呤	bwp
噯	bwpt
嗳	bwpv
喻	bwqn
吤	bwr
唏	bwsm
唋	bwt
嗱	bwtg
啥	bwtm
噅	bwto
喰	bwv
唂	bwwb
唑	bwwj
嗲	bwwq
嗡	bwxc
哸	bwxk
嗘	bwxs
史	bwy
唅	bwyb
嗆	bwyb
嗿	bwym
唸	bwyp
吟	bwyv
噙	bwyx
叱	bx
咍	bxb
嗈	bxbv
嚩	bxdg
嗤	bxkl
呉	bxkw
叫	bxl
吮	bxqg
哟	bxqy
喙	bxse
吳	bxsy
哞	bxtl
唉	bxts
呣	bxu
呶	bxvy
哛	bxwc
唆	bxwt
吡	bxx
噝	bxx
呦	bxxc
嚛	bxxd
嘇	bxxe
哔	bxxf
咝	bxxk
喈	bxxr
嘰	bxxw
吆	bxxy
唁	by
嗃	bybb
哼	bybc
喨	bybm
嚷	bybq
嚎	bybs
噋	bybt
啷	byc
嚌	bycr
嘛	bydd
噺	byde
嚫	bydq
嚰	byds
嚤	bydt
嚒	bydx
嗻	byfo
喥	byfv
嚝	byfw
呅	byg
咏	byio
嘀	bymf
吭	bymg
喑	byn
噇	bynj
啼	bypm
噫	bypu
嗙	bypy
噷	byqw
哜	byr
喭	byse
嗾	bytt
哴	byv
嘃	byvl
啐	bywf
囃	bywr
囄	bywr
唹	bywu
咬	byww
唼	byxk
唷	byxq
噰	byxr
咳	byxw
呟	byxx
了	c
阵	caf
陣	caf
陈	caiw
塦	caj
隇	cakx
隁	canx
陿	casw
司	cb
叾	cb
廻	cbb
孠	cbck
隤	cblm
陨	cbm
隕	cbm
覗	cbmq
廽	cbnj
亟	cbvk
焏	cbvo
凾	cbvx
羽	cc
翀	ccbl
羿	ccf
阠	ccfg
翄	ccfv
羾	ccjl
阤	ccl
翨	ccnl
翼	ccnw
翚	ccpa
翬	ccpa
翴	ccpa
翑	ccqb
翆	ccqf
翵	ccqx
戳	ccra
翟	ccrl
習	ccrn
翫	ccrq
鸐	ccrq
翭	ccrt
翜	ccsw
頨	ccsw
翇	ccsy
阞	cct
毣	ccta
翐	cctw
翍	ccvv
戮	ccwa
勠	ccwc
翂	ccwc
鄝	ccwc
翏	ccwe
剹	ccwn
鹨	ccwq
雡	ccwr
顟	ccws
翪	ccwt
翯	ccyb
翠	ccyf
翞	ccyi
翌	ccyu
翣	ccyx
廼	cdg
陻	cdj
隭	cdsm
陠	cdu
阪	cevy
隫	cffm
乙	cg
卂	cgfg
蝨	cgfl
鳵	cgfq
	cgii
氹	cgio
丮	cgjl
厾	cgjx
乪	cgnb
虱	cgtl
飞	cgu
飛	cguu
飝	cguu
陦	chgy
隞	chtw
陬	chvy
廴	ciii
阝	ciii
卩	ciii
	ciii
	ciii
隚	cij
隙	cini
阥	cio
陗	ciq
隲	citv
那	cjc
际	cji
隢	cjjs
陼	cjn
阮	cjqg
阱	cjr
隯	cjvg
陡	cjw
陸	cjwj
陵	cjwt
陆	cjxl
阹	cjxy
子	ck
刁	ck
孒	ck
陚	ckal
阿	ckb
隔	ckbu
娿	ckbx
孨	ckcc
孖	ckck
孴	ckcn
孺	ckds
孤	ckex
孑	ckii
孙	ckiw
孲	ckkn
阷	ckll
勐	ckmc
孟	ckmn
孭	ckmw
陃	ckmw
孾	ckmx
陳	ckni
螴	cknl
敶	cknt
孮	ckpj
孞	ckpu
孢	ckqv
愻	cktp
孜	cktw
孫	cktx
陕	ckus
孻	ckvm
隬	ckww
孔	ckx
孡	ckxb
陘	ckxj
孩	ckyw
也	cl
阽	clb
陟	clit
骘	cliv
卫	clk
隵	clka
卍	clkl
阯	cll
乸	clxu
阻	cmh
隑	cmku
阳	cn
陫	cnf
陧	cnj
陽	cnke
隄	cnkl
隈	cnkq
隅	cnmy
廸	cno
隰	cnxo
刀	co
召	cob
邵	cobc
劭	cobc
卲	cobc
刟	cobn
欩	cobq
巶	cobv
綤	cobx
刕	cocc
脋	cocq
鳭	coqx
阦	cow
刃	coy
刄	coy
丒	coyk
歰	coyl
忍	coyp
乃	cp
阸	cpcg
孕	cpck
朶	cpd
刴	cpdn
呄	cpfb
尕	cpiw
院	cpjq
盁	cpmn
鼐	cpmv
随	cpsq
隧	cpus
戤	cpva
盈	cpvm
夃	cpvy
陀	cpx
及	cpy
阴	cq
阺	cqay
際	cqji
陥	cqln
﨩	cqmx
隖	cqo
隐	cqp
陊	cqqy
陷	cqrj
陒	cqsc
陶	cqtm
陱	cqud
隐	cqvp
隝	cqx
隗	crb
陴	crfg
附	crgy
隍	crh
隉	crjl
陮	crl
廹	crn
隩	crus
阨	csc
陙	csj
隳	csji
墮	csjj
隓	csjj
嶞	csjm
隋	csjq
陓	csjx
陭	cskb
阫	csl
陑	csm
陌	csn
陏	csq
堕	csqj
陾	cssy
陇	cst
隴	cst
陝	csty
陜	csww
阢	csx
力	ct
加	ctb
哿	ctbb
乫	ctbc
架	ctbd
嗧	ctbf
贺	ctbm
袈	ctbq
毠	ctbt
驾	ctbv
妿	ctbx
劦	ctcc
阣	ctcg
陁	ctcl
勰	ctcp
脅	ctcq
姭	ctcx
阩	ctf
阡	ctfg
陞	ctfj
陲	ctfk
陹	ctfn
陎	ctiw
廷	ctj
隀	ctkj
隆	ctkt
郔	ctlc
阼	ctlg
延	ctll
頲	ctsw
颋	ctsw
降	cttj
劜	ctx
习	cu
阧	cufg
隣	cuqt
隣	cuqt
隊	cuse
墜	cusj
鐆	cusw
隒	cuw
隘	cuwm
隦	cvby
陉	cvj
隥	cvku
建	cvl
限	cvq
陂	cvv
険	cwbw
險	cwbw
队	cwg
隂	cwha
险	cwik
坠	cwj
檃	cwjd
櫽	cwjd
隱	cwjp
陯	cwmf
阾	cwp
隃	cwqn
阶	cwr
除	cwt
隠	cwvp
陰	cwyx
乜	cx
廵	cxg
陋	cxkw
隟	cxnd
阭	cxqg
墬	cxsj
陖	cxwt
阰	cxx
陛	cxxj
階	cxxr
孓	cy
卪	cy
陪	cyb
防	cyc
隮	cycr
障	cyfg
埅	cyj
阬	cymg
隌	cyn
隡	cyst
陔	cyxw
要	d
栕	da
棧	daat
樞	dabb
棫	dabk
櫃	dabm
械	daf
框	dah
栋	daiw
桎	daj
栻	dajl
樲	dajm
椷	dakb
楲	dakx
枒	dal
槭	dali
榧	danf
椡	dang
椻	danx
橬	daqn
柩	daqy
桡	dasx
栈	dat
桟	dat
檻	datm
欖	datq
柜	dav
樫	davj
枢	dawy
杙	day
杏	db
槶	dbak
梠	dbb
榀	dbbb
橾	dbbd
樿	dbbf
梙	dbbl
槵	dbbp
欕	dbbt
枴	dbco
柺	dbct
梱	dbd
檲	dbdg
棝	dbfb
栶	dbg
桯	dbh
檝	dbha
楫	dbhd
椢	dbhy
枵	dbkx
樻	dblm
梋	dbq
柷	dbqg
棞	dbtd
枳	dbw
榲	dbwm
枷	dcb
柖	dcb
柌	dcb
極	dcbk
栩	dcc
栛	dccc
桗	dcd
杨	dce
朰	dcg
梛	dcjc
李	dck
杍	dck
樄	dcki
杝	dcl
朷	dco
櫂	dcrl
槢	dcrn
椭	dcsq
朸	dct
梃	dctj
梴	dctl
槂	dctx
榌	dcuu
楗	dcvl
楹	dcvm
樛	dcwe
极	dcy
杒	dcy
梕	dcyp
林	dd
櫺	ddbb
欞	ddbw
郴	ddc
森	ddd
檚	dddv
彬	dde
欛	ddfq
栖	ddg
榑	ddgy
槫	ddgy
樷	ddhv
埜	ddj
禁	ddji
檦	ddjn
樗	ddjx
梄	ddk
梺	ddkl
檒	ddml
槚	ddmw
檟	ddmw
梵	ddmy
檑	ddnb
橝	ddnf
楂	ddnk
焚	ddow
椘	ddp
棾	ddpm
橞	ddpu
梦	ddqy
辳	ddsj
檽	ddsm
樰	ddvh
楚	ddvl
棼	ddwc
棽	ddwv
棶	ddww
婪	ddxk
麓	ddyx
杉	de
椞	ded
櫍	deem
楯	defm
桁	deg
椼	dei
枛	dei
析	dek
栀	dekc
梔	dekv
梹	dekw
蜤	del
榹	delm
晳	den
梑	deow
惁	depu
皙	dern
板	devy
樅	dewl
柧	dex
柝	dey
欌	dfaa
櫙	dfab
枯	dfb
槿	dfbh
欟	dfbq
權	dfbr
栉	dfc
楳	dfd
枿	dff
楛	dffb
橨	dffm
棋	dfh
榵	dfhd
欂	dfig
柑	dfj
樭	dfj
樺	dfkj
橫	dfkw
杆	dfl
植	dfmh
構	dfmj
楧	dfms
槙	dfmw
樠	dfmy
櫗	dfmy
棤	dfn
橶	dfna
檊	dfnf
橗	dfnq
模	dfns
横	dfnw
櫣	dfpa
桲	dfpc
檬	dfps
楜	dfq
櫒	dfqj
槆	dfqn
檧	dfqp
橵	dfqt
﨓	dfrg
櫵	dfro
欍	dfrr
檴	dfrv
椛	dfrx
楉	dfsb
樥	dfth
楠	dfu
樯	dfub
欗	dfui
櫹	dfvr
椟	dfvs
枝	dfvy
栱	dfw
檋	dfwa
榙	dfwb
椹	dfx
枻	dfx
櫀	dfx
楪	dfxd
橭	dfyf
西	dg
栗	dgd
鷅	dgdq
覆	dget
覉	dgfb
覇	dgfq
覊	dgfv
襾	dgii
覀	dgii
垔	dgj
鄄	dgjc
瓢	dgje
票	dgji
飄	dgjl
剽	dgjn
歅	dgjq
顠	dgjs
飘	dgjw
甄	dgjy
贾	dgmw
覃	dgnf
鷣	dgnq
梂	dgoy
覄	dgrs
覈	dgrt
材	dgt
覂	dgtp
粟	dgud
覅	dgxe
要	dgxk
村	dgy
枉	dh
枨	dha
棖	dha
櫮	dhbb
檉	dhbh
椰	dhc
梆	dhc
楔	dhcs
栮	dhd
梇	dhf
梼	dhgy
欇	dhhh
櫘	dhhp
槥	dhhv
棒	dhjl
楱	dhks
樍	dhmw
椿	dhn
棈	dhq
樁	dhrj
榛	dhtd
棷	dhvy
榡	dhx
木	di
橕	dial
橖	did
朩	diii
桫	diit
樘	dij
欓	dimo
檔	dinb
梢	diq
栦	dir
桄	disx
杪	dit
档	divh
樑	diwd
榉	diwj
﨔	diwt
桜	dixk
杜	dj
樾	djax
桔	djb
檯	djba
橲	djbb
樹	djbg
榬	djbq
桏	djc
标	dji
柰	dji
柡	djio
桂	djj
橈	djjs
栲	djkx
杠	djl
杢	djl
櫝	djmm
槓	djmw
楮	djn
榸	djnj
梽	djpu
杬	djqg
歀	djqw
檮	djvg
隸	djvi
檣	djwb
枎	djwg
櫕	djwm
槻	djwq
棱	djwt
槸	djwy
栳	djx
杇	djx
榼	djxm
榰	djxn
枟	djxy
本	dk
醆	dkaa
醎	dkab
醧	dkab
柯	dkb
酲	dkbh
梀	dkbi
櫴	dkbm
醞	dkbm
楅	dkbn
楋	dkbn
樕	dkbq
欜	dkbq
釅	dkbt
梪	dkbu
槅	dkbu
翉	dkcc
醪	dkce
酏	dkcl
杤	dkct
枺	dkd
醽	dkdb
醂	dkdd
醰	dkdf
醥	dkdj
醹	dkds
酺	dkdu
枅	dkf
酤	dkfb
醛	dkfh
酣	dkfj
酐	dkfl
醋	dkfn
醼	dkfo
醐	dkfq
杅	dkg
酎	dkgy
酉	dkii
酬	dkir
酵	dkjc
醻	dkjg
醘	dkjm
醏	dkjn
酛	dkjq
酜	dkjw
酝	dkjx
酠	dkkb
酑	dkkg
酊	dkkl
醩	dkkn
酽	dkkt
酾	dkky
朾	dkl
酟	dklb
柾	dkll
醵	dkls
酮	dkmb
楝	dkmi
杮	dkml
醠	dkmm
槽	dkmn
醲	dkms
醴	dkmu
酘	dkmv
柄	dkmw
欐	dkmy
栵	dkng
棟	dkni
桓	dknk
醍	dknl
醖	dknm
榗	dknn
橊	dknn
醒	dknt
桠	dknu
醭	dknu
椏	dknu
梗	dknw
醌	dknx
醈	dkoo
酧	dkpg
醡	dkpl
醓	dkpm
酖	dkpq
醚	dkpu
酡	dkpx
酩	dkqb
酔	dkqf
醄	dkqt
酌	dkqy
醜	dkrb
醀	dkrl
醮	dkro
醙	dkrv
醢	dksm
酭	dksq
醃	dksx
酞	dksy
酕	dkta
酪	dktb
酥	dktd
酷	dktj
酢	dktl
醺	dkto
酰	dktq
桺	dktv
酶	dktx
梾	dkud
酙	dkuf
醝	dkuj
枰	dkuk
梧	dkvb
醁	dkvh
配	dkvk
醱	dkvm
醑	dkvq
醊	dkvv
桋	dkvw
棲	dkvx
酚	dkwc
酹	dkwg
酫	dkwh
酴	dkwt
檷	dkww
醶	dkww
酗	dkwx
杖	dkwy
朽	dkx
醦	dkxe
桱	dkxj
枑	dkxk
酯	dkxn
酳	dkxq
酸	dkxt
杶	dkxx
酦	dkxy
醅	dkyb
醣	dkyb
醇	dkyc
醉	dkyf
醯	dkym
醕	dkyn
釄	dkyn
醷	dkyp
醸	dkyq
釀	dkyq
酼	dkyr
醾	dkyu
酿	dkyv
醨	dkyx
醿	dkyx
檅	dlat
枮	dlb
樐	dlbo
朴	dlg
桛	dljl
椒	dlkv
杫	dll
螙	dll
椃	dlmg
樝	dlmh
桢	dlmw
槕	dlnd
棹	dlnf
櫨	dlnm
櫖	dlnp
栌	dlvd
栌	dlvt
橴	dlxx
榩	dlyg
相	dm
	dm
柵	dmf
欁	dmfd
檂	dmfs
椣	dmfw
机	dmg
柤	dmh
査	dmh
柟	dmj
椆	dmjb
枏	dmjg
檡	dmju
桐	dmkb
檈	dmkq
榿	dmku
柮	dmm
栅	dmmk
欋	dmmr
欔	dmmv
樱	dmmx
柶	dmn
檌	dmnf
榾	dmp
想	dmpu
枧	dmqg
椤	dmqy
欈	dmrb
槯	dmrl
椯	dmsm
柍	dmsy
楓	dmtl
棡	dmum
棢	dmuy
杸	dmv
楇	dmvb
桤	dmvk
梖	dmw
椇	dmw
梤	dmwc
枘	dmwg
梣	dmwv
枫	dmwy
杣	dmx
欏	dmxr
檙	dmxv
杋	dmy
枬	dmy
楞	dmyc
杳	dn
榻	dncc
棵	dnd
棑	dnf
桿	dnfl
樶	dnhv
榥	dnis
梩	dnj
榯	dnjg
查	dnk
柦	dnk
楊	dnke
棏	dnkg
椳	dnkq
鸉	dnkq
皶	dnkv
梬	dnkx
柛	dnl
榅	dnmn
槾	dnmv
椙	dnn
橸	dnnn
櫑	dnnn
欙	dnnx
柚	dno
柙	dnp
楒	dnpu
楬	dnqw
槛	dntm
榄	dntq
樸	dnuh
檏	dnuh
欉	dnuv
楐	dnwr
樏	dnx
栧	dnxt
棍	dnxx
雨	do
霵	doba
霝	dobb
酃	dobc
霣	dobm
龗	dobs
露	dobt
靈	dobw
孁	dobx
霫	docr
霆	doct
雭	docy
雬	dod
霖	dodd
霦	dode
霜	dodm
鸘	dodq
鹴	dodq
霺	doet
雸	dofj
霸	dofq
霙	dofs
靀	dofs
霰	doft
靊	dohu
霑	doib
霘	doib
霂	doid
霔	doih
靋	doil
霈	doim
霄	doiq
霪	doit
霗	doiw
霟	doiw
霐	doix
霮	doix
霶	doiy
鄠	dojc
霴	doji
靆	doji
靅	dojm
霊	dojn
靉	dojt
霼	doju
霒	dojv
雩	dojx
雫	dokl
霋	dokx
霌	domb
雵	doms
霻	domu
雷	donb
霷	done
霏	donf
靁	donn
靐	donn
霬	donw
電	donx
檆	doob
櫿	doob
橯	dooc
橩	doom
雿	dooq
棪	doow
靌	dopm
靏	dopq
霥	dops
桃	doqg
霡	doqi
霤	doqn
霢	doqq
雹	doqv
檪	dord
霍	dorl
霓	dorq
靃	dorr
雼	dos
雳	dosc
震	dosj
靂	dosl
需	dosm
颥	doss
靇	dost
雮	dota
雾	dotc
雽	dotu
霉	dotx
霱	dovb
霧	dovc
霨	dovg
雪	dovh
霿	dovm
雺	dovt
霚	dovt
霯	dovu
霞	dovv
霹	dovy
杰	dow
雰	dowc
霾	dowj
零	dowp
靎	dowq
霅	doy
雱	doyc
霩	doyc
雯	doyg
霁	doyr
雴	doyu
霠	doyv
霭	doyw
霎	doyx
梿	dpaf
楎	dpaf
槤	dpaf
榁	dpaj
槴	dpbv
櫏	dpdv
槟	dpew
椗	dpg
櫶	dphp
棕	dpji
椌	dpjl
梡	dpjq
橽	dpju
楦	dpkk
柠	dpkl
檳	dpkm
檛	dpmb
楄	dpmf
椬	dpmh
榊	dpnl
榠	dpnw
檸	dppk
櫁	dppl
樒	dppm
橣	dppm
椀	dpqc
枕	dpqg
檫	dpqj
榷	dprl
樎	dprn
槣	dpsb
榢	dpse
棙	dpsu
柲	dpt
楁	dptb
槰	dpth
榨	dptl
榓	dptm
槌	dptv
杺	dpu
檤	dpur
檖	dpus
棺	dpv
枦	dpv
樋	dpvm
柼	dpw
榕	dpwb
棎	dpwd
柁	dpx
桉	dpxk
椖	dpyc
榟	dpyf
枂	dq
桰	dqab
棔	dqan
柢	dqay
枸	dqb
梚	dqbq
橡	dqbs
欃	dqby
枊	dqc
栁	dqc
桞	dqc
橮	dqcm
榴	dqcn
檞	dqct
棴	dqcv
楤	dqep
枠	dqfg
栎	dqiw
橹	dqkn
桷	dqm
槝	dqmx
栒	dqn
櫓	dqon
櫯	dqot
棚	dqq
栘	dqqy
桅	dqsc
橪	dqso
檐	dqsy
朹	dqt
柳	dqtc
榤	dqtd
桝	dqtj
枃	dqu
橳	dquc
椈	dqud
槲	dquf
枹	dqv
棦	dqvl
栬	dqvn
杴	dqw
樢	dqx
构	dqxy
杓	dqy
杦	dqy
杊	dr
棩	dr
梍	drag
栰	drat
槐	drb
椺	drbd
槜	drcp
榫	drfg
榭	drgy
楻	drh
椴	drhm
楾	drio
桕	drj
檓	drjm
櫸	drkj
欅	drkt
楩	drkw
椎	drl
檇	drlc
樤	drld
樇	drlq
棉	drml
柏	drn
槹	drof
橰	drof
樵	drow
櫋	drpy
棿	drqg
欆	drrv
槔	drsf
栿	drsu
栣	drtj
樬	drtp
櫆	druf
梻	drvr
楰	drwg
杹	drx
梎	drx
桦	drxf
槪	drxq
檄	dryt
柘	ds
檶	dsab
桮	dsb
槗	dsbb
枙	dsc
枥	dsct
椓	dse
櫔	dsfy
槈	dsgy
桭	dsj
槬	dsje
櫉	dsjg
楏	dsjj
楕	dsjq
桍	dsjx
柸	dsk
椅	dskb
橱	dskg
杯	dsl
栫	dslc
栭	dsm
柨	dsml
榎	dsmt
櫌	dsmt
栢	dsn
栯	dsq
榞	dsri
栊	dst
櫳	dst
櫪	dstl
枤	dsu
橑	dsui
橛	dsuq
柭	dsvy
梜	dsww
樉	dsww
杌	dsx
杕	dsy
枆	dta
杔	dtag
格	dtb
椥	dtb
楀	dtby
杚	dtcg
柂	dtcl
柇	dtd
鬱	dtde
枡	dtf
杄	dtfg
檱	dtfh
棰	dtfk
橅	dtfo
杽	dtg
栍	dth
桻	dthl
株	dtiw
梏	dtj
櫡	dtjn
杵	dtk
棅	dtki
櫄	dtko
柞	dtlg
栝	dtm
桖	dtmn
栴	dtmy
楿	dtn
梸	dtng
椱	dtnt
楸	dtow
柉	dtp
櫷	dtpx
欑	dtqm
橁	dtqn
権	dtrl
橋	dtsb
桥	dtsr
枖	dtsy
栙	dttj
橇	dttt
柊	dtu
櫤	dtun
桘	dtv
櫛	dtvc
枚	dtw
柣	dtwg
柹	dtxt
梅	dtxu
杁	dty
樦	dtyh
楡	dtyx
甫	du
榈	dubb
喸	dubx
棬	duc
郙	duc
乶	ducg
椦	duct
樽	dudg
楢	dudk
橂	duds
栟	duf
枓	dufg
鄟	dugc
剸	dugn
鷒	dugq
尃	dugy
專	dugy
甎	dugy
样	duh
橍	duh
栏	duhg
栤	duio
様	duio
柈	duj
槎	dujl
欄	duki
橧	dumn
盙	dumn
橺	dun
椫	dunf
椪	dunu
榚	duow
椚	dup
惠	dupu
棁	duq
橌	duq
椾	duqn
櫩	duqr
橉	duqt
栨	duqw
鵏	duqx
橷	durq
栚	dusy
檥	duta
櫊	dutb
槉	duts
橏	duub
檨	duuq
梯	duvt
槏	duw
榏	duwm
楼	duxk
櫢	duxt
旉	duyc
樣	duyi
懯	duyp
敷	duyt
杩	dv
榪	dv
楃	dvaj
櫭	dvak
概	dvaq
椲	dvbt
檘	dvby
杼	dvc
楖	dvc
梮	dvcb
樼	dvcc
杻	dvf
椐	dvfb
榐	dvfq
树	dvgy
椂	dvh
橄	dvht
欘	dvil
棣	dvio
榍	dviq
樨	dvit
柽	dvj
樳	dvjg
椵	dvjv
杞	dvk
櫈	dvkm
楑	dvks
橙	dvku
橚	dvlr
楣	dvm
桶	dvmj
杷	dvn
棂	dvow
梞	dvpu
梫	dvpv
根	dvq
楈	dvq
櫲	dvqs
柫	dvr
櫇	dvsw
柕	dvt
梶	dvta
橘	dvtb
楙	dvtd
楺	dvtd
壄	dvtj
懋	dvtp
榒	dvuu
柀	dvv
槡	dvvd
橃	dvvm
棳	dvvv
榋	dvvv
橻	dvvv
杛	dvx
柅	dvx
权	dvy
杈	dvy
朳	dw
柗	dwb
椧	dwbc
梲	dwbq
検	dwbw
檢	dwbw
枪	dwc
厀	dwc
椕	dwcd
桴	dwck
枌	dwco
棌	dwd
榝	dwdm
樧	dwdm
朲	dwg
栓	dwh
桼	dwi
检	dwik
檼	dwjp
桧	dwjx
楥	dwkv
枍	dwkx
棆	dwmf
檜	dwmn
橎	dwn
柃	dwp
橓	dwpt
榆	dwqn
槄	dwrj
桸	dwsm
梌	dwt
榣	dwtm
櫾	dwtx
檭	dwvq
勑	dwwc
郲	dwwc
麧	dwwc
麪	dwwc
棥	dwwd
麱	dwwd
鬰	dwwe
麯	dwwf
枞	dwwg
桽	dwwj
麵	dwwj
櫼	dwwk
蠜	dwwl
賚	dwwm
燓	dwwo
愸	dwwp
憖	dwwp
憗	dwwp
鶆	dwwq
麭	dwwq
麲	dwwq
樊	dwws
攀	dwwt
麴	dwwu
麬	dwwv
鐢	dwww
麩	dwww
麳	dwww
麮	dwwx
麶	dwwx
麫	dwwx
桵	dwxk
棇	dwxp
榽	dwxs
椶	dwxt
松	dwxy
梒	dwyb
槍	dwyb
棯	dwyp
枔	dwyv
檎	dwyx
札	dx
朼	dx
枱	dxb
朻	dxl
蚻	dxl
樌	dxmw
栺	dxn
椔	dxnb
樔	dxnd
桚	dxqy
檰	dxrm
椽	dxse
桳	dxsf
梉	dxsj
欚	dxsl
桙	dxtl
栂	dxu
梭	dxwt
枇	dxx
紮	dxx
柪	dxxc
櫟	dxxd
槮	dxxe
梐	dxxj
楷	dxxr
橼	dxxs
槇	dxxw
機	dxxw
檵	dxxx
术	dy
朮	dy
杧	dya
樴	dyat
棓	dyb
槁	dybb
椁	dybc
椋	dybi
檩	dybj
檀	dybk
榱	dybq
檺	dybs
橔	dybt
檁	dybt
榔	dyc
枋	dyc
櫅	dycr
榳	dyct
榇	dyd
櫬	dydq
梓	dyf
樟	dyfg
樜	dyfo
櫎	dyfw
柱	dyh
栐	dyio
桩	dyj
堏	dyj
櫥	dyjg
槠	dyjn
樀	dymf
杭	dymg
柿	dyml
櫰	dymq
橦	dynj
槞	dynx
楴	dypm
怸	dypu
檍	dypu
怷	dypu
榜	dypy
樃	dyq
樈	dyqg
橠	dyqq
椨	dyrg
棭	dyry
楌	dyse
檹	dytb
椸	dytc
柆	dyu
桹	dyv
榶	dyvb
槺	dyvi
槦	dyvl
櫠	dyvm
櫦	dyvt
椩	dyvw
椊	dywf
棜	dywu
校	dyww
樆	dywx
樚	dyx
椄	dyxk
橀	dyxm
槒	dyxn
棛	dyxq
梳	dyxr
核	dyxw
很	e
彻	eaco
獑	eaek
犽	eal
狨	eas
狘	eax
徊	ebb
玁	ebbt
徎	ebh
狆	ebl
狷	ebq
犯	ec
狲	eciw
彵	ecl
猛	ecmn
狿	ectl
猻	ectx
徤	ecvl
犼	ecx
彶	ecy
狇	ed
徆	edg
猼	edgy
徱	edji
猹	ednk
獳	edsm
猍	edww
循	eefm
狐	eex
狜	efb
玂	efbe
獾	efbr
獖	effm
猉	efh
犴	efl
盾	efm
徝	efmh
德	efmp
鶞	efmq
质	efmw
瞂	efmy
猎	efn
徣	efn
猫	efnb
獏	efns
獚	efnw
獦	efnw
獴	efps
猢	efq
獲	efrv
行	eg
彻	egac
衐	egav
徊	egbb
徎	egbh
彵	egcl
徤	egcv
彶	egcy
徆	egdg
徱	egdj
徠	egdw
術	egdy
狾	egek
循	egem
衎	egfl
徝	egfm
徣	egfn
德	egfp
衚	egfq
衖	egfw
衠	egfw
彺	egh
衍	egi
徜	egib
彳	egii
愆	egip
待	egjg
街	egjj
衏	egjq
徺	egjs
徒	egjw
衙	egkb
徚	egki
徑	egkj
征	egkl
惩	egkp
徕	egku
徙	egll
徏	eglt
徟	egmb
衕	egmb
徂	egmh
垼	egmj
懲	egmp
衢	egmr
微	egmt
徽	egmt
徵	egmt
徴	egmt
徾	egmt
鰴	egmt
黴	egmt
幑	egmt
役	egmv
徘	egnf
得	egng
忁	egni
徥	egnl
徧	egpf
徖	egpj
徇	egqn
衡	egqs
鴴	egqx
鵆	egqx
鸻	egqx
彴	egqy
彽	egqy
徨	egrh
徼	egrt
徛	egsb
徿	egst
犲	egt
御	egtc
徃	egth
禦	egtj
衝	egtj
衘	egtm
復	egtt
徉	eguh
従	egul
衜	egur
徶	egut
径	egvj
律	egvl
衞	egvm
很	egvq
彿	egvr
徫	egvt
衛	egvt
徲	egvt
彼	egvv
讆	egvy
讏	egvy
衔	egw
銜	egw
聳	egwh
從	egwl
徻	egwn
熧	egwo
彾	egwp
慫	egwp
衑	egwp
徯	egws
徐	egwt
徭	egwt
彸	egwx
衟	egxm
後	egxt
彷	egyc
往	egyh
徸	egyj
忀	egyq
徹	egyt
衒	egyx
徬	egyy
狂	eh
彺	eh
猰	ehcs
猜	ehq
鵟	ehqx
獉	ehtd
獓	ehtw
爪	ei
犭	eiii
彡	eiii
	eiii
猀	eiit
坕	eij
徜	eimb
猟	eimj
爮	eiqv
爬	eivn
狤	ejb
猿	ejbq
橥	ejd
待	ejgy
徺	ejhs
狋	eji
獟	ejjs
乕	ejml
猪	ejn
徒	ejw
狫	ejx
斤	ek
后	ekb
劶	ekbc
郈	ekbc
垕	ekbj
獭	ekbm
卮	ekc
邤	ekc
劤	ekct
啠	ekeb
斦	ekek
質	ekem
劕	eken
徵	ekh
丘	ekk
邱	ekkc
岳	ekkm
乒	ekkt
兵	ekkw
屔	ekkx
乓	ekky
征	ekll
惩	eklp
獿	eklt
微	ekmg
徚	ekmi
斶	ekml
犻	ekml
幑	ekml
黴	ekmo
狟	eknk
鰴	ekqo
欣	ekqw
颀	eksw
徕	ekud
狭	ekus
巵	ekvn
獮	ekww
徽	ekx
徑	ekxj
斥	eky
独	el
獩	elat
辵	ell
徙	elll
猇	elmg
虒	elmg
歋	elmq
鷉	elmq
	elmq
獹	elnm
兏	elsx
頿	elxs
猠	emfw
狙	emh
徂	emh
垼	emj
徟	emjb
狦	emjn
狪	emkb
懲	emkp
獧	emkq
玃	emmv
猾	emp
獨	emql
猡	emqy
獕	emrl
猯	emsm
猦	emtl
役	emv
猧	emvb
狈	emw
狽	emw
玀	emxr
猓	end
猅	enf
徘	enf
猂	enfl
狸	enj
狚	enk
得	enkg
徥	enkl
狮	enkm
猥	enkq
忁	enmi
獌	enmv
猖	enn
狎	enp
猬	enq
猲	enqw
猩	enth
獛	enuh
猑	enxx
悐	eopu
狣	eoqg
狄	eow
狩	epgy
猔	epji
狞	epkl
獱	epkm
猵	epmf
猽	epnw
獰	eppk
猏	epv
狖	epw
彽	eqay
狗	eqb
獬	eqct
狝	eqi
覛	eqmq
狥	eqn
徇	eqn
犰	eqt
狍	eqv
狰	eqvl
犱	eqy
犳	eqy
彴	eqy
猈	erfg
徨	erh
猚	erl
狛	ern
獔	erof
獋	erof
猊	erqg
獡	erqo
獆	ersf
猴	ervt
獀	ervy
獥	eryt
狵	ese
澃	esio
狉	esk
猗	eskb
頾	eslx
盨	esmn
獶	esmt
獂	esri
徿	est
犾	esu
獠	esui
獗	esuq
须	esw
須	esw
狹	esww
犹	esx
媭	esxk
嬃	esxk
狢	etb
犵	etcg
狏	etcl
狌	eth
獯	etko
狅	etj
狧	etm
猘	etmn
猁	etng
獢	etsb
獅	etvm
舟	eu
艦	euam
艥	euba
舯	eubl
郍	euc
艋	eucm
舠	euco
艇	euct
舾	eudg
猶	eudk
艝	eudv
舨	euev
艓	eufd
艜	eufm
艨	eufs
艧	eufv
舼	eufw
徉	euh
艡	euin
艄	euiq
艢	eujb
舡	eujl
舸	eukb
艚	eukn
従	eul
艣	eulc
従	eull
艫	eulm
舻	eulv
船	eumb
槃	eumd
鞶	eumf
螌	euml
幋	eumm
艒	eumm
盤	eumm
盘	eumn
舰	eumq
磐	eums
搫	eumt
獙	eumt
般	eumv
鎜	eumw
舢	eumx
舤	eumy
艃	eunj
舳	euno
舺	eunp
艑	eupf
舮	eupv
舵	eupx
艪	euqn
獜	euqt
鵃	euqx
鸼	euqx
艬	euqy
艎	eurh
艊	eurm
舶	eurn
艘	eurv
舿	eusx
舦	eusy
艂	euth
艁	eutj
舴	eutl
艞	eutq
舽	eutt
舧	euty
艤	euua
艖	euuj
艗	euum
艏	euur
艛	euux
艍	euvf
舥	euvn
艉	euvt
艠	euvu
艙	euwb
舱	euwc
獈	euwm
舲	euwp
艌	euwp
艅	euwt
艐	euwt
舩	euwx
猐	eux
舭	euxx
舫	euyc
艟	euyj
航	euym
艈	euyr
艩	euyr
艆	euyv
艔	euyv
舣	euyw
舷	euyx
艕	euyy
犸	ev
戶	ev
獁	ev
殷	evcm
慇	evcp
乺	evec
所	evek
狃	evf
徲	evit
径	evj
猳	evjv
猤	evks
獼	evkw
律	evl
猸	evm
峱	evmx
狠	evq
很	evq
猕	evqi
狒	evr
彿	evr
徫	evt
獝	evtb
猱	evtd
狓	evv
彼	evv
狔	evx
反	evy
獫	ewbw
猃	ewik
狯	ewjx
猨	ewkv
獪	ewmn
狑	ewp
彾	ewp
狶	ewsm
徯	ewsx
狳	ewt
徐	ewt
猞	ewtm
猙	ewvl
聳	ewwh
從	ewwl
熧	ewwo
慫	ewwp
彸	ewx
猣	ewxt
獊	ewyb
瓜	ex
獵	exbx
狁	exqg
瓟	exqv
瓝	exqy
猭	exse
瓥	exsl
瓞	extw
狻	exwt
狕	exxc
狴	exxj
後	exxt
狺	ey
猄	eybi
獽	eybq
獤	eybt
彷	eyc
獐	eyfg
獷	eyfw
往	eyh
犿	eylg
犺	eymg
獞	eynj
徬	eypy
獍	eyqg
犷	eys
鸑	eysq
狱	eysu
狼	eyv
猝	eywf
狡	eyww
徹	eyxt
真	f
茝	fa
茞	fa
蔵	faa
载	faaf
臷	faaj
菚	faat
哉	fab
蓲	fabb
荿	fac
苆	faco
栽	fad
酨	fadk
蔪	faek
莗	faf
蓒	fafl
	faii
荎	faj
葴	fakb
葳	fakx
芽	fal
蛓	fal
蒧	falb
蒇	famw
菿	fang
韯	fank
戴	fanw
烖	faow
苉	faqg
截	farl
茙	fas
荛	fasx
茂	fat
蘙	fatc
藍	fatm
苣	fav
藖	favm
菣	favy
藏	faxa
蘻	faxx
芅	fay
荗	fay
裁	fayq
古	fb
蔮	fbak
茴	fbb
莒	fbb
虈	fbbb
勸	fbbc
鄿	fbbc
酄	fbbc
蘄	fbbe
蕇	fbbf
飌	fbbl
鹳	fbbq
雚	fbbr
颧	fbbs
萼	fbbx
莂	fbcn
茵	fbg
蕺	fbha
葺	fbhd
菋	fbji
薗	fbjq
茣	fbks
瓳	fbky
莡	fbll
蒉	fblm
蕗	fblt
蒷	fbm
莴	fbmw
蒽	fbpu
胡	fbq
勀	fbqc
勊	fbqc
兝	fbqc
兙	fbqf
兛	fbqf
克	fbqg
兣	fbqj
兡	fbqn
剋	fbqn
兢	fbqq
鹕	fbqq
鶘	fbqq
鶦	fbqq
兞	fbqt
鸪	fbqx
蓶	fbrl
菌	fbtd
故	fbtw
蔨	fbuc
嘏	fbvv
苬	fbwg
莔	fbwm
蒕	fbwm
荶	fbwv
辜	fbyf
节	fc
茄	fcb
苕	fcb
藬	fcbm
莻	fcbx
荔	fccc
菰	fcex
艺	fcg
荪	fciw
芓	fck
蔯	fcki
芀	fco
艿	fcp
荫	fcq
藋	fcrl
艻	fct
莛	fctj
莚	fctl
蕯	fctt
蓀	fctx
萾	fcvm
蓼	fcwe
蘟	fcwp
蒢	fcwt
蔭	fcwx
芤	fcx
芨	fcy
荵	fcyp
萨	fcys
薩	fcyt
藲	fdab
莕	fdb
蘦	fdbb
虂	fdbt
菻	fdd
菥	fdek
茜	fdg
蒪	fdgy
蓴	fdgy
荰	fdj
蔈	fdji
蓕	fdjj
蕓	fdjx
薽	fdjy
苯	fdk
莤	fdk
葙	fdm
蕾	fdnb
蕈	fdnf
萙	fdpq
蕙	fdpu
蘎	fdqv
藿	fdrl
蘸	fdro
薷	fdsm
莆	fdu
蓜	fdvk
蕶	fdwp
萊	fdww
菘	fdwx
葽	fdxk
蓏	feex
荇	feg
葕	fei
蕏	fejn
蓗	fejw
芹	fek
茊	fek
茩	fekb
蓰	fell
薇	femt
蒰	femv
荻	feow
蘅	feqs
获	fesu
蕦	fesw
莸	fesx
蓹	fetc
蘌	fetj
蕧	fett
蕕	feud
莥	fevf
葎	fevl
蒑	fevm
蓯	fewl
蒣	fewt
苽	fex
革	ff
苦	ffb
鞇	ffbg
蓳	ffbh
鞓	ffbh
鞼	ffbm
鞙	ffbq
鞀	ffcb
勒	ffct
鞬	ffcv
靭	ffcy
靱	ffcy
靸	ffcy
靳	ffek
鞯	fffc
鞢	fffd
韊	fffi
鞾	fffj
靬	fffl
鞴	fffm
鞲	fffm
蕡	fffm
韉	fffo
韄	fffv
鞳	fffw
靾	fffx
韈	fffy
鞡	ffgy
萁	ffh
鞝	ffib
鞺	ffij
鞜	ffin
鞩	ffin
鞘	ffiq
苷	ffj
靯	ffj
鞊	ffjb
鞋	ffjj
韇	ffjm
靺	ffkd
韁	ffkk
靪	ffkl
鞆	ffkw
鞕	ffkw
芉	ffl
鞐	ffll
靻	ffmh
鞅	ffms
蒖	ffmw
靹	ffmw
蘣	ffnh
蘳	ffnj
鞸	ffnj
靼	ffnk
鞮	ffnl
鞰	ffnm
韅	ffno
鞨	ffnw
鞉	ffoq
荸	ffpc
鞚	ffpj
鞑	ffps
韃	ffpu
韆	ffpv
鞍	ffpx
葫	ffq
蔕	ffqm
鞔	ffqq
鞠	ffqu
鞄	ffqv
鞫	ffqy
鞞	ffrf
鞭	ffrw
靴	ffrx
靰	ffsx
鞽	fftb
鞂	fftd
鞦	ffto
鞒	fftr
萳	ffu
蔷	ffub
鞧	ffud
靽	ffuj
鞻	ffux
鞣	ffvd
靵	ffvf
靷	ffvl
靶	ffvn
鞎	ffvq
鞁	ffvv
鞃	ffvx
芰	ffvy
鞈	ffwb
鞥	ffwf
鞱	ffwr
鞵	ffws
靲	ffwv
鞖	ffwx
葚	ffx
藄	ffx
靿	ffxc
葉	ffxd
蘛	ffxq
鞿	ffxw
鞛	ffyb
鞟	ffyc
鞹	ffyc
韀	ffyo
十	fg
賷	fgbm
喪	fgbq
萔	fgcb
協	fgcc
博	fgdg
蒱	fgdu
卉	fgf
翸	fgfc
枽	fgfd
桒	fgfd
卋	fgfk
贲	fgfm
歕	fgfq
尭	fgfs
鼖	fgfv
莏	fgit
荴	fgjw
蓵	fgkl
直	fgmh
矗	fgmm
惪	fgmp
鷏	fgmq
颠	fgms
蘀	fgmu
真	fgmw
嗭	fgmx
戟	fgna
翰	fgnc
乾	fgnc
亁	fgnc
榦	fgnd
斡	fgnf
韩	fgnj
螒	fgnl
菗	fgno
朝	fgnq
雗	fgnr
韓	fgnt
倝	fgnw
乹	fgnx
畞	fgny
莍	fgoy
勃	fgpc
孛	fgpc
郣	fgpc
愂	fgpp
鹁	fgpq
疐	fgpv
索	fgpx
菢	fgqv
蓷	fgrl
菝	fgsy
葀	fgtm
啬	fgub
丧	fguq
翅	fgvc
攳	fgvg
萚	fgvj
觌	fgvq
卖	fgvs
支	fgvy
协	fgwc
赍	fgwm
菈	fgyu
其	fh
苌	fha
萇	fha
蘁	fhbb
葜	fhcs
茸	fhd
棊	fhd
斯	fhek
蟴	fhel
藉	fhfn
蕻	fhfw
蘴	fhhu
蔧	fhhv
基	fhj
菶	fhjl
蜝	fhl
蔶	fhmw
萶	fhn
剘	fhng
藕	fhny
惎	fhpu
期	fhq
菁	fhq
朞	fhq
欺	fhqw
碁	fhs
蓁	fhtd
蔜	fhtw
藂	fhvi
蕼	fhvl
菆	fhvy
甚	fhx
綦	fhx
戡	fhxa
勘	fhxc
斟	fhxf
綦	fhxi
夦	fhxq
歁	fhxq
尠	fhxt
諅	fhy
蘵	fhya
蕖	fiad
蘫	fiam
菃	fiav
藻	fibd
薀	fibm
范	fic
菬	ficb
荡	fice
莯	fid
藫	fidf
薄	fidg
薸	fidj
蒲	fidu
蒎	fieq
葓	fifw
蔳	fihq
艹	fiii
廾	fiii
卄	fiii
卌	fiii
莎	fiit
茳	fijl
蔆	fijt
菏	fikb
萍	fiku
蔋	filv
菹	fimh
莈	fimv
蕩	fine
蕰	finm
蘯	finm
蕅	finy
莐	fipq
莦	fiq
蒅	fiqd
萷	fiqn
萢	fiqv
萡	firn
蒞	firy
茪	fisx
落	fitb
萿	fitm
蓱	fiuf
葏	fivl
菠	fivv
蔢	fivx
虃	fiwk
藩	fiwn
蒤	fiwt
菭	fixb
薻	fixd
茫	fiya
薃	fiyb
蓅	fiyr
蒗	fiyv
甘	fj
芏	fj
薹	fjba
薣	fjbv
苇	fjc
邯	fjc
某	fjd
苿	fjiw
茥	fjj
葑	fjjg
蒜	fjji
蕘	fjjs
斠	fjmf
冓	fjmj
藚	fjmm
觏	fjmq
顜	fjms
蒆	fjmx
茿	fjmy
著	fjn
芫	fjqg
荺	fjqu
莰	fjqw
羐	fjqy
甛	fjtm
蕔	fjuv
蓻	fjuy
薵	fjvg
薔	fjwb
芙	fjwg
爇	fjwo
菱	fjwt
莁	fjww
藝	fjwx
蓺	fjwy
芌	fjx
荖	fjx
蓋	fjxm
蓍	fjxn
芸	fjxy
蘾	fjyq
廿	fk
苛	fkb
囏	fkbb
勤	fkbc
鄞	fkbc
斳	fkbe
堇	fkbh
藾	fkbm
葍	fkbn
懃	fkbp
戁	fkbp
觐	fkbq
蔌	fkbq
歎	fkbq
歏	fkbq
虉	fkbq
覲	fkbq
難	fkbr
荳	fkbu
蒚	fkbu
艱	fkbv
臡	fkbw
茉	fkd
茾	fkf
華	fkfj
荆	fkfn
鷨	fkfq
芋	fkg
丗	fkii
	fkii
黃	fkkw
艼	fkl
芐	fklg
蔫	fklo
蘷	fklt
虁	fklt
蕀	fkmi
茦	fkmi
萰	fkmi
芾	fkml
莿	fkmn
蓸	fkmn
颟	fkms
蓛	fkmt
苪	fkmw
昔	fkn
黇	fknb
斮	fkne
薚	fkne
斢	fknf
茢	fkng
黈	fknh
菄	fkni
黊	fknj
薤	fknk
剒	fknn
鹊	fknq
黅	fknv
皵	fknv
黄	fknw
炗	fkow
帯	fkpm
帶	fkqm
慸	fkqp
散	fkqt
菾	fksi
芜	fksx
酀	fkuc
莱	fkud
苹	fkuk
燕	fkuo
鷰	fkuq
荚	fkus
嬊	fkux
萐	fkvl
荑	fkvw
萋	fkvx
共	fkw
輂	fkwa
恭	fkwi
蕐	fkwj
蛬	fkwl
拲	fkwt
巷	fkwv
薾	fkww
世	fkx
勚	fkxc
勩	fkxc
葝	fkxc
枼	fkxd
葬	fkxf
塟	fkxj
莖	fkxj
贳	fkxm
萅	fkxn
芚	fkxx
干	fl
茧	fl
薉	flat
苫	flb
蓾	flbo
邗	flc
麉	flfy
蘋	flis
荹	flit
茮	flki
菽	flkv
芷	fll
蘃	flld
蕋	flll
萀	flmg
蔖	flmh
刊	flng
蘆	flnm
藘	flnp
覝	floq
薒	flqu
鳱	flqx
顸	flsw
虄	fltt
攼	fltw
茈	flx
苜	fm
蔑	fmay
苘	fmb
莇	fmct
萛	fmf
矗	fmfm
蕽	fmfs
芁	fmg
苴	fmh
苒	fmj
苚	fmj
萺	fmjm
薯	fmjn
茼	fmkb
芇	fml
萜	fmlb
茁	fmm
蕒	fmmw
蘡	fmmx
荝	fmng
萴	fmng
蓇	fmp
薎	fmpa
鄸	fmpc
瞢	fmpm
夢	fmpq
顭	fmps
蘉	fmpv
薨	fmpx
甍	fmpy
苋	fmqg
薥	fmql
萝	fmqy
蘮	fmsn
鶧	fmsq
繤	fmsx
英	fmsy
葻	fmtl
蔝	fmud
菵	fmuy
芟	fmv
萵	fmvb
藈	fmvs
芮	fmwg
颠	fmws
萞	fmwx
繭	fmxl
蘿	fmxr
薡	fmxv
藣	fmxx
芃	fmy
藅	fmyn
苗	fnb
莮	fnct
菒	fnd
菓	fnd
菲	fnf
草	fnfg
蓽	fnfj
莳	fngy
蕞	fnhv
荲	fnj
蒔	fnjg
韮	fnk
葨	fnkq
勱	fnmc
蠆	fnml
躉	fnml
蒀	fnmn
蔓	fnmv
萬	fnmy
菖	fnn
蘽	fnnd
蘲	fnnj
蕌	fnnn
藟	fnnn
虆	fnnx
苖	fno
葸	fnpu
萌	fnq
葛	fnqw
鹋	fnqx
募	fnsc
慕	fnsi
墓	fnsj
蟇	fnsl
幕	fnsm
暮	fnsn
摹	fnst
蓦	fnsv
莫	fnsy
葃	fntl
蓝	fntm
薱	fnug
茰	fnwy
蔂	fnx
菎	fnxx
蔊	fonf
藀	fooo
菼	foow
薬	ford
薠	fosw
苂	fow
蕿	fowv
蘹	foyq
芝	fp
莲	fpaf
荤	fpaf
葷	fpaf
蓮	fpaf
营	fpbb
蔰	fpbv
茕	fpcf
茡	fpck
劳	fpct
荣	fpd
蒏	fpdk
蒁	fpdy
菦	fpek
藆	fpft
萣	fpg
藼	fphp
莹	fphy
荥	fpio
茔	fpj
蒄	fpjg
萗	fpji
莞	fpjq
蒙	fpjs
氋	fpjt
蔲	fpjt
薘	fpju
蔻	fpjv
苎	fpk
荢	fpkg
萱	fpkk
苧	fpkl
薲	fpkm
藗	fpkq
蔩	fpkw
萤	fpl
蘧	fpls
薖	fpmb
萹	fpmf
萓	fpmh
带	fpml
蓂	fpnw
荧	fpow
蘂	fppd
薴	fppk
藌	fppl
蔤	fppm
蕊	fppp
菀	fpqc
莺	fpqx
蒬	fpqy
蒮	fprl
蓿	fprn
藛	fpro
藭	fprv
菪	fps
蓫	fpse
藔	fpsi
葖	fpsu
荙	fpsy
苾	fpt
蓬	fpth
荦	fptl
芯	fpu
蒾	fpud
芦	fpv
菅	fpv
菺	fpv
蓪	fpvm
蕸	fpvv
蓥	fpw
茓	fpw
蓉	fpwb
萦	fpx
荌	fpxk
藡	fpyf
胡	fq
芪	fqag
茋	fqay
苟	fqb
茗	fqb
葂	fqbc
莬	fqbq
菟	fqby
苑	fqc
茒	fqc
蒥	fqcn
藰	fqcn
葾	fqcp
荕	fqct
薢	fqct
菔	fqcv
葡	fqdu
芴	fqe
葱	fqep
茐	fqey
蔡	fqji
茚	fqkc
蓟	fqkn
藓	fqku
藑	fqmt
萯	fqmw
荀	fqn
葪	fqng
﨟	fqnw
薊	fqon
蘇	fqot
蘚	fqou
萠	fqq
葋	fqqb
蒯	fqqn
茤	fqqy
萏	fqrj
蔸	fqrq
薝	fqsy
艽	fqt
茆	fqtc
檠	fqtd
荈	fqtj
葄	fqtl
蟼	fqtl
萄	fqtm
憼	fqtp
擎	fqtt
驚	fqtv
敬	fqtw
警	fqty
蕂	fquc
菊	fqud
蔛	fquf
藤	fqui
虅	fquv
苞	fqv
萉	fqvn
芡	fqw
蕵	fqwv
茑	fqx
蔦	fqx
蒭	fqxx
芶	fqxy
芍	fqy
芄	fqy
芕	fqy
茷	frat
蒐	frb
葆	frbd
茽	frbl
藵	frbq
芿	frcp
茠	frd
萆	frfg
苻	frgy
葟	frh
葮	frhm
蒨	frhq
葲	frio
茌	frj
芢	frjg
荷	frkb
藇	frkw
萑	frl
蓧	frld
蓚	frle
蓨	frlq
莜	frlt
虋	frmc
苮	frmx
苩	frn
蕉	frow
蒠	frpu
萖	frqg
蕮	frqo
莵	frqy
菂	frqy
舊	frrj
藠	frrr
茯	frsu
荏	frtj
莋	frtl
蔥	frtp
薁	frus
葩	frvn
劐	frvn
葔	frvt
葠	frvv
蒦	frvy
蓃	frvy
萸	frwg
蘤	frwo
蓖	frwx
花	frx
葰	frxt
蒊	frxx
蓓	fryb
薂	fryt
莅	fryu
若	fsb
鄀	fsbc
蠚	fsbl
惹	fsbp
苊	fsc
苈	fsct
莽	fsf
莾	fsff
蓐	fsgy
莀	fsj
萘	fsji
藸	fsjn
荂	fsjx
苤	fsk
芣	fsl
荐	fslc
茬	fslj
荋	fsm
菴	fsnx
蒝	fsri
藞	fsss
茏	fst
蘢	fst
蕤	fsth
藶	fstl
蕨	fsuq
茇	fsvy
莢	fsww
芖	fsy
葢	fsym
芼	fta
莪	ftat
茖	ftb
萂	ftb
萭	ftby
芞	ftc
莠	ftcp
芊	ftfg
菙	ftfk
蕪	ftfo
苼	fth
莑	fthl
蕱	ftiq
茱	ftiw
薐	ftjt
蘍	ftkc
董	ftkj
薰	ftko
苲	ftlg
蒩	ftmh
蘈	ftms
萫	ftn
莉	ftng
藒	ftnw
萩	ftow
藊	ftpf
蔾	ftqd
蘓	ftqo
蘒	ftqp
菞	ftqt
藜	ftqw
蘒	ftqx
萟	ftqy
薭	ftrf
薙	ftrl
蕎	ftsb
荞	ftsr
芺	ftsy
蘒	fttp
苳	ftu
萪	ftuf
苸	ftuk
蕛	ftut
孽	ftvc
蘖	ftvd
躠	ftvl
蒒	ftvm
蘬	ftvm
糵	ftvu
蒛	ftvw
薛	ftvy
苵	ftwg
萎	ftxk
蘶	ftxr
莓	ftxu
蘩	ftxx
南	fu
蔄	fub
菤	fuc
荓	fuf
荘	fuj
蒫	fujl
蓤	fujt
蘭	fuki
虌	fump
蔽	fumt
蕳	fun
蕲	fune
蓔	fuow
菛	fup
蕄	fupu
莌	fuq
蕑	fuq
蒋	fuqg
薋	fuqm
葥	fuqn
茨	fuqw
藱	furb
蔺	furl
蘱	fuss
献	fusu
蒺	futs
蒍	fuvo
蒹	fuw
苝	fux
蒌	fuxk
蒴	fuxq
薮	fuxt
苢	fv
苠	fvag
蔇	fvaq
蘗	fvbd
蔃	fvbl
葦	fvbt
薜	fvby
芧	fvc
莭	fvc
虇	fvfr
荨	fvgy
菉	fvh
葞	fvhd
蒸	fvio
萧	fvir
菡	fvix
茎	fvj
蔚	fvjg
藯	fvjp
葭	fvjv
芑	fvk
葵	fvks
茟	fvl
藎	fvlm
蔬	fvlr
苐	fvlt
葿	fvm
芭	fvn
菷	fvpm
茛	fvq
茀	fvr
蓣	fvsw
茅	fvt
芛	fvt
荱	fvta
莙	fvtb
蓩	fvtc
葇	fvtd
蔒	fvto
鶜	fvtq
荬	fvus
蒻	fvuu
蕟	fvvm
芵	fvwg
芎	fvx
苨	fvx
苰	fvxy
芆	fvy
荩	fvyu
菳	fw
共	fw
荅	fwb
蘥	fwbf
蘝	fwbq
蘞	fwbt
薟	fwbw
苍	fwc
棻	fwcd
莩	fwck
葐	fwcm
芬	fwco
苏	fwct
菜	fwd
蔱	fwdm
葊	fwf
荃	fwh
莶	fwik
蔹	fwit
苶	fwiw
荟	fwjx
萲	fwkv
菕	fwmf
薈	fwmn
蕃	fwn
剳	fwng
苅	fwng
薶	fwnj
苓	fwp
蕣	fwpt
薆	fwpt
萮	fwqn
鴱	fwqx
鷋	fwqx
芥	fwr
蓞	fwrj
藐	fwrq
莃	fwsm
茶	fwt
荼	fwt
蔿	fwto
蘨	fwtx
巷	fwv
巷	fwvp
薍	fwvx
苁	fwwg
莝	fwwj
葅	fwwm
蓌	fwwt
芲	fwx
蓊	fwxc
荽	fwxk
蒵	fwxs
葼	fwxt
艾	fwy
莟	fwyb
蒼	fwyb
菍	fwyp
芩	fwyv
茹	fxb
苔	fxb
葈	fxbd
蘊	fxbm
蒘	fxbt
蕠	fxbx
菇	fxfb
荮	fxgy
荭	fxjl
蘏	fxjs
葘	fxkn
莼	fxkx
蒳	fxmw
菑	fxnb
蕴	fxnm
蘰	fxnv
蘕	fxph
蕝	fxqv
药	fxqy
蘠	fxsb
蒃	fxse
薅	fxsg
莊	fxsj
芗	fxt
蘔	fxts
蔠	fxtu
薿	fxtv
荍	fxtw
苺	fxu
蒶	fxwc
荾	fxwt
藧	fxwv
芘	fxx
蕬	fxx
孶	fxxc
苭	fxxc
藥	fxxd
蔘	fxxe
荜	fxxf
蒈	fxxr
茲	fxxx
葌	fxxx
薌	fxyc
虊	fxyd
苡	fxyw
芒	fya
菩	fyb
蒿	fybb
蔀	fybc
藁	fybd
葶	fybk
蓑	fybq
藳	fybt
薧	fybx
芳	fyc
蓈	fyc
虀	fyck
薺	fycr
蔴	fydd
薪	fyde
蘼	fydn
藽	fydq
蘑	fyds
藦	fydt
莘	fyf
蔁	fyfg
蓆	fyfm
蔗	fyfo
芠	fyg
薼	fyj
藷	fyjn
薦	fyko
苄	fylg
蔏	fymb
蔐	fymf
苀	fymg
蔎	fymv
萻	fyn
蕫	fynj
蔼	fynw
藨	fyow
蒂	fypm
薏	fypu
蒡	fypy
蓢	fyq
蒟	fyqb
菧	fyqy
荒	fyr
荠	fyr
萕	fyr
藙	fysm
蓭	fysx
葹	fytc
蔟	fytt
蔙	fytv
苙	fyu
蘪	fyud
薕	fyuw
莨	fyv
蓎	fyvb
菮	fyvw
萃	fywf
蓙	fywj
萒	fywq
蓘	fywq
蔉	fywq
蘺	fywr
菸	fywu
蘐	fywv
茭	fyww
蓠	fywx
蔍	fyx
菨	fyxk
蓄	fyxn
茺	fyxq
蕹	fyxr
荄	fyxw
拆	g
挋	ga
摳	gabb
掝	gabk
捓	gac
摲	gaek
捙	gaf
搟	gafl
擓	gair
拣	gaiw
挃	gaj
拭	gajl
搣	gako
撼	gakp
揻	gakx
摵	gali
捯	gang
揠	ganx
撍	gaqn
挠	gasx
找	gat
攬	gatq
拒	gav
摼	gavj
抠	gawy
扣	gb
摑	gbak
捛	gbb
操	gbbd
撣	gbbf
捌	gbcn
拐	gbct
捆	gbd
挰	gbh
擑	gbha
揖	gbhd
掴	gbhy
捉	gbll
撌	gblm
损	gbm
損	gbm
攌	gbmq
摁	gbpu
捐	gbq
拀	gbqg
挹	gbvn
抧	gbw
搵	gbwm
招	gcb
拁	gcb
挧	gcc
拹	gccc
搚	gccq
挅	gcd
扬	gce
扟	gcfg
挪	gcjc
扡	gcl
掹	gcmn
扔	gcp
擢	gcrl
摺	gcrn
撱	gcsq
扐	gct
挺	gctj
挻	gctl
搎	gctx
揵	gcvl
报	gcvy
摎	gcwe
扨	gcy
扱	gcy
搮	gdd
拪	gdg
搏	gdgy
摽	gdji
摴	gdjx
擂	gdnb
撢	gdnf
揸	gdnk
攉	gdrl
擩	gdsm
捕	gdu
哲	geb
踅	gebl
乴	gecg
梊	ged
揗	gefm
抓	gei
埑	gej
折	gek
拞	gek
捳	gekm
捠	gekw
蜇	gel
搋	gelm
擨	gelq
搬	gemv
晢	gen
烲	geow
焎	geow
悊	gepu
挀	geq
掀	geqw
硩	ges
鋬	gevw
扳	gevy
銴	gew
摐	gewl
娎	gexk
誓	gey
拆	gey
裚	geyq
擹	gfbq
攤	gfbr
撕	gfek
擛	gffd
掑	gfh
搑	gfhd
拑	gfj
擆	gfjn
撶	gfkj
扞	gfl
搆	gfmj
攧	gfms
搷	gfmw
措	gfn
撠	gfna
描	gfnb
擀	gfnf
摸	gfns
撗	gfnw
擖	gfnw
捞	gfpc
攃	gfqj
摕	gfqm
撒	gfqt
擮	gfrl
擭	gfrv
掿	gfsb
擜	gfsu
揇	gfu
技	gfvy
拱	gfw
搭	gfwb
搽	gfwt
抴	gfx
揕	gfx
揲	gfxd
捄	ggoy
抂	gh
掁	gha
揶	ghc
挷	ghc
揳	ghcs
挕	ghd
挵	ghf
攝	ghhh
捧	ghjl
揍	ghks
摂	gho
掅	ghq
摏	ghrj
搸	ghtd
摄	ghvv
掫	ghvy
	gia
撐	gial
扌	giii
挱	giit
摚	gij
攩	gimo
擋	ginb
搅	gipq
捎	giq
挄	gisx
抄	git
挘	gitc
撑	gitg
毮	gitt
挡	givh
扗	gj
拮	gjb
擡	gjba
撷	gjbs
持	gjgy
抺	gjiw
挂	gjj
掛	gjjl
撓	gjjs
拷	gjkx
扛	gjl
摃	gjmw
撎	gjpu
抏	gjqg
抟	gjv
擣	gjvg
撵	gjwa
扶	gjwg
攅	gjwm
摫	gjwq
捇	gjwr
掕	gjwt
扝	gjx
搕	gjxm
搘	gjxn
抎	gjxy
抾	gjxy
抲	gkb
捒	gkbi
攋	gkbm
揊	gkbn
揦	gkbn
攮	gkbq
搹	gkbu
抹	gkd
扜	gkg
拝	gkhl
打	gkl
拺	gkmi
揀	gkmi
抦	gkmw
掚	gkmy
攦	gkmy
挒	gkng
搢	gknn
挜	gknu
掗	gknu
挭	gknw
掭	gksi
抚	gksx
抨	gkuk
挟	gkus
捂	gkvb
捷	gkvl
挗	gkvw
捿	gkvx
擟	gkww
扙	gkwy
挳	gkxj
扽	gkxx
拈	glb
掳	glct
扑	glg
捗	glit
挊	gljl
拤	glkl
掓	glkv
扯	gll
摣	glmh
揁	glmw
擄	glnc
掉	glnf
攎	glnm
攄	glnp
摅	glpu
掯	glq
據	glse
摢	gltu
	gm
挆	gmd
擃	gmfs
捵	gmfw
抯	gmh
拥	gmj
抩	gmj
擇	gmju
摆	gmjx
挏	gmkb
擐	gmkq
拙	gmm
攫	gmmv
撄	gmmx
搰	gmp
挸	gmqg
擉	gmql
攜	gmrb
摧	gmrl
揣	gmsm
抰	gmsy
掆	gmum
投	gmv
抐	gmwg
攞	gmxr
擺	gmxx
抇	gn
搨	gncc
捰	gnd
排	gnf
捍	gnfl
撮	gnhv
捏	gnj
捚	gnj
担	gnk
揚	gnke
提	gnkl
揋	gnkq
抻	gnl
捜	gnlv
揾	gnmn
摱	gnmv
攂	gnnn
抽	gno
押	gnp
揌	gnpu
掦	gnqe
擝	gnqm
揭	gnqw
掲	gnqx
撂	gntb
揽	gntq
撲	gnuh
擈	gnuh
摞	gnx
拽	gnxt
掍	gnxx
捑	gnxy
撔	gnyi
揯	gokk
搄	gokk
攚	goob
撈	gooc
掞	goow
挑	goqg
求	goy
盚	goym
慦	goyp
裘	goyq
救	goyt
皳	goyv
挥	gpaf
撺	gpbl
搧	gpcc
挖	gpcg
攨	gpee
摈	gpew
搲	gpex
攓	gpfl
攐	gpfq
掟	gpg
挝	gpgy
搳	gphb
攇	gphp
控	gpjl
捖	gpjq
撻	gpju
揎	gpkk
拧	gpkl
擯	gpkm
撾	gpmb
揙	gpmf
抭	gpmg
擰	gppk
捥	gpqc
抌	gpqg
擦	gpqj
搉	gprl
摍	gprn
攛	gprx
捩	gpsu
挞	gpsy
挓	gpta
揢	gptb
摓	gpth
搾	gptl
搥	gptv
抋	gpu
护	gpv
掮	gpv
捾	gpv
搈	gpwb
探	gpwd
摉	gpwq
拕	gpx
按	gpxk
擿	gpyf
抈	gq
扺	gqag
捪	gqan
抵	gqay
拘	gqb
挽	gqbq
搀	gqbu
攙	gqby
抑	gqc
抛	gqct
揔	gqep
摖	gqji
撸	gqkn
捔	gqm
换	gqms
捣	gqmx
摀	gqo
擼	gqon
掤	gqq
拸	gqqy
掐	gqrj
撚	gqso
擔	gqsy
扏	gqt
搩	gqtd
掏	gqtm
抣	gqu
掬	gqud
抱	gqv
挣	gqvl
扻	gqw
搊	gqxx
抅	gqxy
执	gqy
扚	gqy
揈	gqy
势	gqyc
垫	gqyj
蛰	gqyl
贽	gqym
热	gqyo
鸷	gqyq
挚	gqyt
絷	gqyx
携	grcp
捭	grfg
拊	grgy
揘	grh
揑	grjl
攑	grkj
推	grl
擕	grlc
拍	grn
擤	grnr
撨	grow
掜	grqg
	grrv
搝	grsu
拰	grtj
摠	grtp
擙	grus
扸	grv
搜	grvy
攪	grwq
撽	gryt
拓	gs
扼	gsc
拋	gsct
捹	gsff
搙	gsgy
揼	gsio
振	gsj
摦	gsje
捺	gsji
捱	gsjj
撦	gsjn
挎	gsjx
抷	gsk
掎	gskb
抔	gsl
拵	gslc
抪	gsml
擾	gsmt
擫	gsns
掩	gsnx
拻	gsow
拢	gst
攏	gst
攊	gstl
撩	gsui
撅	gsuq
拔	gsvy
挾	gsww
摤	gsww
扰	gsx
扤	gsx
才	gt
托	gtag
挌	gtb
扢	gtcg
拖	gtcl
抍	gtf
扦	gtfg
捶	gtfk
撫	gtfo
插	gtfr
抙	gtg
捀	gthl
捁	gtj
揰	gtkj
挿	gtkl
拃	gtlg
揝	gtln
括	gtm
拠	gtmg
鼒	gtmv
攥	gtmx
摥	gtne
揪	gtow
抸	gtp
攒	gtqm
撟	gtsb
挢	gtsr
擌	gtsw
扷	gtsy
撬	gttt
擶	gtun
擳	gtvc
撘	gtwb
抶	gtwg
捼	gtxk
挴	gtxu
扖	gty
搃	gubp
捲	guc
擲	gudc
撙	gudg
揂	gudk
拼	guf
抖	gufg
撋	guh
拦	guhg
拌	guj
搓	gujl
攔	guki
撯	gum
撇	gumt
掸	gunf
掽	gunu
扪	gup
捫	gup
捝	guq
撊	guq
揹	guq
揃	guqn
撛	guqt
掷	gusc
搁	gutb
搼	gutg
挮	guvt
搛	guw
搤	guwm
搂	guxk
搠	guxq
擞	guxt
攁	guyv
据	gv
抿	gvag
握	gvaj
摡	gvaq
摾	gvbl
擗	gvby
抒	gvc
揤	gvc
挶	gvcb
扭	gvf
据	gvfb
搌	gvfq
挦	gvgy
扫	gvh
撖	gvht
拯	gvik
捸	gvio
摨	gvit
撏	gvjg
择	gvjl
揆	gvks
撜	gvku
掻	gvl
捅	gvmj
掘	gvmm
把	gvn
掃	gvpm
拫	gvq
揟	gvq
拂	gvr
摊	gvrl
捤	gvta
捃	gvtb
揉	gvtd
摒	gvuf
搦	gvuu
披	gvv
搡	gvvd
撥	gvvm
掇	gvvv
撰	gvvw
	gvvy
抉	gvwg
抳	gvx
扠	gvy
択	gvy
搱	gvyf
搔	gvyl
扒	gw
捦	gw
拾	gwb
掵	gwbc
挩	gwbq
撿	gwbw
抢	gwc
捊	gwck
扮	gwco
採	gwd
摋	gwdm
抮	gwe
揜	gwf
揺	gwfx
捋	gwgy
拴	gwh
捡	gwik
援	gwkv
掄	gwmf
播	gwn
拎	gwp
授	gwpv
揄	gwqn
揿	gwqw
扴	gwr
搯	gwrj
捈	gwt
摇	gwtm
撝	gwto
扵	gwu
掙	gwvl
挫	gwwj
攕	gwwk
抡	gwx
挼	gwxk
捴	gwxp
搶	gwyb
摿	gwyn
捻	gwyp
搇	gwyq
扲	gwyv
擒	gwyx
扎	gx
抬	gxb
擸	gxbx
拚	gxf
掼	gxmw
指	gxn
摷	gxnd
抁	gxqg
撧	gxqv
拶	gxqy
撪	gxsa
掺	gxse
掾	gxse
摪	gxsg
攭	gxsl
挨	gxts
擬	gxtv
拨	gxty
拇	gxu
捘	gxwt
批	gxx
紥	gxx
拗	gxxc
擽	gxxd
摻	gxxe
撡	gxxi
揩	gxxr
払	gxy
拟	gxyw
寸	gy
掊	gyb
搞	gybb
掠	gybi
擅	gybk
攘	gybq
撴	gybt
攟	gybt
攍	gyby
擠	gycr
攠	gydn
擵	gydt
摭	gyfo
擴	gyfw
抆	gyg
拄	gyh
掂	gylb
抃	gylg
摘	gymf
抗	gymg
揞	gyn
刌	gyng
撞	gynj
摔	gyof
揥	gypm
搒	gypy
挔	gyq
摬	gyqg
掋	gyqy
挤	gyr
捬	gyrg
掖	gyry
扩	gys
摌	gyst
揓	gytc
攈	gytd
拉	gyu
攗	gyud
搪	gyvb
掶	gyvw
捽	gywf
攡	gywr
挍	gyww
摛	gywx
摝	gyx
接	gyxk
搐	gyxn
擁	gyxr
撤	gyxt
拡	gyxy
现	h
长	ha
琖	haat
琙	habk
鬛	habx
琊	hac
珹	hac
髫	hacb
髢	hacl
髤	had
鬆	hadx
鬚	haes
鬂	haew
鬍	hafq
鬕	hafs
髸	hafw
鬒	hafw
髰	hafx
鬗	hafy
髶	hahd
鬊	hahn
髟	haii
髾	haiq
髿	hait
髻	hajb
鬐	hajn
髨	hajq
珬	hak
瑊	hakb
髩	hakc
鬎	hakn
镾	hakw
瓺	haky
玡	hal
髭	halx
髷	hamf
髠	hamg
髯	hamj
鬟	hamq
鬞	hams
鬄	hane
鬘	hanv
鬔	haph
鬃	hapj
鬡	hapk
鬢	hapm
髧	hapq
鬓	hapw
鬇	haql
鬅	haqq
髱	haqv
镹	haqy
髹	hard
镽	hasi
髬	hask
髵	hasm
鬌	hasq
髪	hasv
髡	hasx
髮	hasy
髦	hata
髼	hath
璼	hatm
髺	hatm
鬁	hatn
鬏	hato
镺	hats
镻	hatw
鬈	hauc
鬋	haun
鬙	haun
鬝	haun
鬜	hauq
鬀	haut
鬑	hauw
肆	havl
镼	havm
髴	havr
髳	havt
髲	havv
髽	hawj
鬠	hawn
鬉	hawt
鬖	haxe
鬣	haxx
髣	hayc
鬤	hayq
噩	hbbb
璪	hbbd
珚	hbg
珵	hbh
珿	hbll
璝	hblm
璐	hblt
琄	hbq
珈	hcb
玿	hcb
珝	hcc
珕	hccc
玚	hce
瓍	hcpq
玏	hct
嗸	hctb
聱	hcth
珽	hctj
鳌	hctk
螯	hctl
赘	hctm
熬	hcto
鼇	hctp
鷔	hctq
獒	hcts
摮	hctt
骜	hctv
敖	hctw
鏊	hctw
嫯	hctx
謷	hcty
璆	hcwe
璻	hcyf
耳	hd
聝	hdak
聀	hdat
聖	hdbh
聩	hdbm
职	hdbw
耶	hdc
琳	hdd
瑮	hdd
璴	hddv
聴	hdfp
瑼	hdgy
聑	hdhd
聶	hdhh
聽	hdhp
聙	hdhq
顳	hdhs
聐	hdjb
耺	hdjx
耵	hdkl
耻	hdll
聃	hdmj
聉	hdmm
刵	hdng
聘	hdnx
聎	hdoq
褧	hdoq
耿	hdow
聢	hdpg
聜	hdpj
聺	hdpj
聍	hdpk
耽	hdpq
恥	hdpu
璤	hdpu
聊	hdqc
聦	hdqp
鵈	hdqx
聸	hdqy
聭	hdrb
聛	hdrf
聰	hdrp
聣	hdrq
瓀	hdsm
聏	hdsm
聗	hdsw
耾	hdsx
毦	hdta
聕	hdtj
聒	hdtm
聅	hdts
聥	hdty
聠	hduf
聪	hdup
联	hdus
鄹	hdvc
棸	hdvd
聚	hdvi
埾	hdvj
焣	hdvo
颞	hdvs
聂	hdvv
娶	hdvx
取	hdvy
聁	hdwc
聬	hdwc
聄	hdwe
聆	hdwp
耹	hdwv
琜	hdww
耴	hdx
聈	hdxc
聨	hdxf
聮	hdxo
聫	hdxs
聯	hdxx
職	hdya
聤	hdyk
璷	hdyt
瓆	heem
珩	heg
珘	heu
瑽	hewl
弄	hf
瑾	hfbh
瓘	hfbr
琪	hfh
玵	hfj
璂	hfj
瓂	hfjm
璍	hfkj
玕	hfl
瑛	hfms
瑱	hfmw
璊	hfmy
璜	hfnw
瑚	hfq
璥	hfqt
瓁	hfrv
璓	hftc
珙	hfw
瑹	hfwt
玴	hfx
三	hg
球	hgoy
玨	hh
瑘	hhc
珥	hhd
琹	hhd
璱	hhht
琫	hhjl
玤	hhl
瑃	hhn
瑟	hhpt
瑧	hhtd
璈	hhtw
琶	hhvn
珡	hhwg
琴	hhwv
瑇	hhxu
琵	hhxx
珏	hhy
王	hi
璖	hiad
耟	hiav
耞	hicb
耔	hick
耢	hifc
耩	hifm
耤	hifn
耯	hifv
耫	hihm
耥	hiib
耒	hiii
耖	hiit
耕	hijr
耘	hijx
耓	hikl
耡	himc
耝	himh
瑺	himl
琐	himw
	himx
	himx
璫	hinb
耦	hiny
耮	hioc
琑	hiq
耨	hisg
耰	hist
頛	hisw
珖	hisx
耗	hita
耧	hiux
耜	hiv
珰	hivh
耙	hivn
耚	hivv
耠	hiwb
耣	hiwf
耛	hixb
珱	hixk
耭	hixw
耲	hiyq
耱	hiys
耪	hiyy
玮	hjc
珪	hjj
玒	hjl
瓄	hjmm
琽	hjn
玩	hjqg
璹	hjvg
瓙	hjvo
玞	hjwg
瓉	hjwm
珯	hjx
珐	hjxy
珷	hkal
珂	hkb
瓎	hkbm
玗	hkg
玎	hkl
瑓	hkmi
瑨	hknn
璢	hknn
玶	hkuk
珸	hkvb
玙	hkx
珁	hkxy
丰	hl
玷	hlb
邫	hlbv
邦	hlc
栔	hlcd
洯	hlci
蛪	hlcl
齧	hlcl
帮	hlcm
恝	hlcp
觢	hlcq
契	hlcs
挈	hlct
絜	hlcx
焘	hlgo
寿	hlgy
酆	hlhc
豓	hlhm
豔	hlhm
熭	hlho
慧	hlhp
豒	hlht
豐	hlhu
彗	hlhv
	hlii
瓛	hlks
琡	hlkv
勣	hlmc
琥	hlmg
靑	hlmk
责	hlmw
琸	hlnf
瓐	hlnm
璿	hlpm
表	hlq
璨	hlqu
艳	hlqv
砉	hls
璩	hlse
剨	hlsn
麺	hltj
麹	hltu
麦	hltw
麸	hltw
素	hlx
玼	hlx
繛	hlxf
毒	hlxu
纛	hlxx
琠	hmfw
玑	hmg
珇	hmh
珃	hmj
琱	hmjb
瑁	hmjm
珮	hmkm
珟	hmkq
環	hmkq
珊	hmmk
璎	hmmx
现	hmqg
瓗	hmrb
璀	hmrl
瑞	hmsm
珼	hmw
琌	hmwv
玬	hmy
琲	hnf
理	hnj
瑒	hnke
瑅	hnkl
珅	hnl
瑥	hnmn
琩	hnn
瓃	hnnn
玾	hnp
瑆	hnth
璞	hnuh
琾	hnwr
琨	hnxx
琝	hnyg
璟	hnyi
琰	hoow
珧	hoqg
琏	hpaf
珲	hpaf
琿	hpaf
璉	hpaf
瑏	hpal
瑸	hpew
琔	hpg
琮	hpji
琓	hpjq
琎	hpjr
瑄	hpkk
璸	hpkm
璌	hpkw
璭	hppa
琬	hpqc
璡	hprl
珌	hpt
璲	hpus
琯	hpv
瑢	hpwb
琛	hpwd
瓋	hpyf
青	hq
玥	hq
琘	hqan
玽	hqb
郬	hqc
瑠	hqcn
珎	hqi
靗	hqis
靓	hqmq
瑍	hqms
瓊	hqmt
珣	hqn
瑦	hqo
靛	hqpg
静	hqql
靘	hqqv
鶄	hqqx
	hqqx
珋	hqtc
靔	hqtc
瑤	hqtm
靝	hqtu
玸	hqv
琤	hqvl
靜	hqwl
鳿	hqx
玖	hqy
玓	hqy
玔	hr
玳	hray
瑰	hrb
珦	hrb
琕	hrfg
瑝	hrh
瑖	hrhm
瑔	hrio
璵	hrkw
琟	hrl
珀	hrn
碧	hrs
璁	hrtp
璬	hryt
琢	hse
琦	hskb
环	hsl
珔	hslc
瓇	hsmt
珛	hsq
瑌	hssy
珑	hst
瓏	hst
瓑	hstl
璙	hsui
顼	hsw
頊	hsw
珴	htat
珞	htb
瑀	htby
琇	htcp
璑	htfo
珄	hth
琒	hthl
璳	htim
珠	htiw
玝	htk
珤	htm
琍	htng
珗	htqg
瓒	htqm
瓈	htqw
琁	htvl
瑡	htvm
玫	htw
珻	htxu
班	huh
珜	huh
瑳	hujl
瓓	huki
璔	humn
瑐	huqn
璘	huqt
珶	huvt
琷	hux
玛	hv
瑪	hv
珉	hvag
瑉	hvan
瑋	hvbt
琚	hvfb
琭	hvh
璕	hvjg
瑕	hvjv
玘	hvk
璒	hvku
珒	hvl
璶	hvlm
璛	hvlr
瑂	hvm
珢	hvq
珺	hvtb
璚	hvtb
瑈	hvtd
玻	hvv
玦	hvwg
瑵	hvyl
兲	hw
玐	hw
琻	hw
珨	hwb
玱	hwc
琈	hwck
玢	hwco
珍	hwe
	hwii
泰	hwio
奉	hwjl
奏	hwks
瑗	hwkv
璯	hwmn
春	hwn
璠	hwn
蠢	hwnl
惷	hwnp
玲	hwp
璦	hwpt
瑷	hwpv
瑜	hwqn
玠	hwr
舂	hwrj
憃	hwrp
琋	hwsm
秦	hwtd
瑶	hwtm
玜	hwxy
琀	hwyb
瑲	hwyb
玪	hwyv
玌	hx
珆	hxb
璏	hxkx
瑻	hxmw
璅	hxnd
玧	hxqg
瑙	hxrw
瑑	hxse
玭	hxx
瓅	hxxd
瑎	hxxr
璣	hxxw
丟	hxy
玉	hy
玊	hy
琂	hy
琣	hyb
琼	hybi
璮	hybk
瓖	hybq
瑯	hyc
璾	hycr
珳	hye
璋	hyfg
玟	hyg
斑	hyh
玣	hylg
瓌	hymq
璄	hyqg
璇	hytv
琅	hyv
瑭	hyvb
琗	hywf
珓	hyww
璃	hywx
珫	hyxq
琉	hyxr
玹	hyxx
少	i
汇	ia
洍	ia
淺	iaat
漚	iabb
淢	iabk
沏	iaco
柒	iad
聻	iaeh
壍	iaej
渐	iaek
魙	iaer
嬱	iaex
洭	iah
洷	iaj
減	iakb
滅	iako
澸	iakp
浳	iaq
潛	iaqn
灊	iaqu
滙	iarl
浇	iasx
浅	iat
瀶	iatb
濫	iatm
灠	iatq
洰	iav
渠	iavd
瀭	iawn
沤	iawy
泧	iax
漍	ibak
洄	ibb
澡	ibbd
潬	ibbf
澏	ibbm
漶	ibbp
湂	ibbx
涃	ibd
涸	ibfb
洇	ibg
浧	ibh
濈	ibha
湒	ibhd
塣	ibhj
涠	ibjc
洖	ibks
沖	ibl
浞	ibll
溃	iblm
潞	iblt
涢	ibm
溳	ibm
涡	ibmw
渑	ibnx
涓	ibq
況	ibqg
溷	ibse
浥	ibvn
潿	ibvt
泅	ibwg
溫	ibwm
氾	ic
沼	icb
泀	icb
泇	icb
濻	icbm
泐	icct
汤	ice
烫	iceo
汛	icfg
汈	ick
汓	ick
池	icl
瀷	icnw
瀈	icpa
瀡	icpq
濯	icrl
漝	icrn
氻	ict
涏	ictj
涎	ictl
漋	ictt
湕	icvl
溋	icvm
漻	icwe
滁	icwt
汲	icy
瀥	icyb
濢	icyf
涩	icyl
涊	icyp
沐	id
淋	idd
溧	idd
潹	iddd
瀮	iddd
漜	iddj
澿	iddj
灀	iddm
澘	iddn
潸	iddq
濋	iddv
漤	iddx
滼	iddy
涁	ide
淅	idek
灞	idfq
洒	idg
溥	idgy
湮	idj
漂	idji
溎	idjj
澐	idjx
酒	idk
泍	idk
湘	idm
潭	idnf
渣	idnk
潓	idpu
瀖	idrl
湐	idrn
濡	idsm
灪	idte
浦	idu
潥	idud
瀒	idwb
漆	idwi
澪	idwp
淶	idww
淞	idwx
沭	idy
洐	ieg
沠	iei
垽	iej
潴	iejn
沂	iek
洉	iekb
浜	iekw
漇	iell
瀊	iemm
瀓	iemt
峾	iemx
派	ieq
漪	iesb
潃	ietq
澓	iett
洀	ieu
溵	ievm
汳	ievy
漎	iewl
泒	iex
泝	iey
灆	ifam
沽	ifb
渽	ifb
漌	ifbh
灌	ifbr
漢	ifbw
湈	ifd
溨	ifd
澌	ifek
泋	iff
濆	iffm
汁	ifg
淇	ifh
泔	ifj
濭	ifjm
渮	ifkb
澕	ifkj
懑	ifkp
满	ifkw
汗	ifl
淽	ifll
淔	ifmh
溝	ifmj
満	ifmm
懣	ifmp
渶	ifms
滇	ifmw
滿	ifmy
瀎	ifmy
渵	ifnb
瀚	ifnc
澣	ifnf
濣	ifnf
瀐	ifnk
濗	ifnm
潮	ifnq
漠	ifns
潢	ifnw
澫	ifny
渤	ifpc
涝	ifpc
浡	ifpc
溁	ifpd
滞	ifpm
濛	ifps
潆	ifpx
滢	ifpy
湖	ifq
滯	ifqm
濍	ifqp
懘	ifqp
潵	ifqt
濩	ifrv
渃	ifsb
漭	ifsf
湳	ifu
灡	ifui
潇	ifvr
渎	ifvs
汥	ifvy
洪	ifw
溚	ifwb
濸	ifwb
港	ifwv
鍙	ifww
泄	ifx
湛	ifx
濝	ifx
渫	ifxd
淓	ifyc
瀳	ifyo
浙	igek
浗	igoy
湁	igwb
汪	ih
涱	iha
潔	ihcx
洱	ihd
涛	ihgy
灄	ihhh
灩	ihhm
濏	ihht
灃	ihhu
潖	ihhv
灧	ihhv
洡	ihi
溙	ihio
淎	ihjl
湊	ihks
沣	ihl
淸	ihmk
渍	ihmw
湷	ihn
清	ihq
瀞	ihql
滟	ihqv
湱	ihs
溱	ihtd
滶	ihtw
滠	ihvv
溸	ihx
氵	iiii
渁	iiio
漟	iij
淌	iimb
灙	iimo
溑	iimw
涾	iin
澢	iinb
消	iiq
洲	iir
洸	iisx
沙	iit
乷	iitc
桬	iitd
鲨	iitk
渻	iitm
鯊	iito
裟	iitq
硰	iits
挲	iitt
娑	iitx
汢	ij
洁	ijb
澎	ijbe
澍	ijbg
溒	ijbq
涍	ijck
漖	ijct
洔	ijgy
沶	iji
沬	ijiw
洼	ijj
湗	ijjg
澆	ijjs
洘	ijkx
江	ijl
瀆	ijmm
渚	ijn
濲	ijpm
瀔	ijpm
瀫	ijpm
涜	ijpq
潱	ijpu
沅	ijqg
鸿	ijqx
汫	ijr
澒	ijsw
涬	ijuj
濤	ijvg
濇	ijwb
淕	ijwj
濽	ijwm
潜	ijwn
浾	ijwr
淩	ijwt
污	ijx
汚	ijx
溘	ijxm
法	ijxy
河	ikb
滒	ikbb
涑	ikbi
瀜	ikbl
濑	ikbm
湢	ikbn
溂	ikbn
漱	ikbq
瀬	ikbs
潄	ikbt
浢	ikbu
滆	ikbu
沫	ikd
汧	ikf
汙	ikg
盓	ikgm
汀	ikl
沔	iklc
泟	ikll
漹	iklo
洓	ikmi
湅	ikmi
洅	ikmj
沛	ikml
漕	ikmn
灑	ikmy
洌	ikng
涷	ikni
洹	iknk
溍	iknn
澑	iknn
浭	iknw
添	iksi
涞	ikud
泙	ikuk
浃	ikus
浯	ikvb
洟	ikvw
淒	ikvx
兴	ikw
举	ikwj
挙	ikwt
濔	ikww
誉	ikwy
汅	ikx
涇	ikxj
溼	ikxj
沍	ikxk
沌	ikxx
浊	il
濊	ilat
沾	ilb
滷	ilbo
惉	ilbp
澞	ilbs
濒	ilis
涉	ilit
渱	iljl
淑	ilkv
沚	ill
澁	illl
滮	ilme
淲	ilmg
浈	ilmw
淖	ilnf
瀘	ilnm
濾	ilnp
渋	ilo
濬	ilpm
滤	ilpu
瀣	ilqk
澯	ilqu
澽	ilse
滹	iltu
泸	ilvd
泸	ilvt
泚	ilx
灗	ilyk
泪	im
濺	imaa
溅	imat
沿	imb
泂	imb
浀	imfk
灎	imfm
濃	imfs
澧	imfu
灔	imfv
淟	imfw
沮	imh
渺	imit
濹	imj
淍	imjb
鼡	imjl
濖	imjn
澤	imju
洞	imkb
洬	imkq
澴	imkq
溦	imkt
澂	imkt
溰	imku
泏	imm
灈	immr
瀴	immx
泗	imn
瀃	imne
测	imng
潉	imnx
潶	imo
滑	imp
漴	impj
涀	imqg
濁	imql
漰	imqq
濉	imrl
潀	imrw
潈	imse
漄	imsj
湍	imsm
瀱	imsn
湠	imso
湨	imsu
泱	imsy
溄	imtj
渢	imtl
潂	imun
没	imv
渦	imvb
浿	imw
浻	imwb
汭	imwg
涔	imwv
沨	imwy
汕	imx
濎	imxv
汎	imy
浵	imye
盕	imym
汩	in
汨	in
沺	inb
畄	inb
溻	incc
巣	ind
淉	ind
渄	inf
戦	infa
単	infg
瀑	infi
滭	infj
涆	infl
潩	infw
滉	inis
涅	inj
浬	inj
溡	injg
濐	injn
泹	ink
湯	inke
淂	inkg
湜	inkl
浉	inkm
盪	inkm
燙	inko
渨	inkq
淠	inkr
淏	inks
獣	inks
涄	inkx
璗	inky
温	inmn
漫	inmv
湡	inmy
澷	inmy
淐	inn
灅	innj
湿	innu
油	ino
渭	inq
渴	inqw
渇	inqx
湦	inth
滥	intm
濧	inug
澲	inuh
溿	inuj
灇	inuv
溭	inwt
漯	inx
濕	inxo
灦	inxs
洩	inxt
混	inxx
渂	inyg
澋	inyi
灏	inys
水	io
呇	iob
浺	iobl
頮	iofs
颒	iofs
淼	ioii
沝	ioio
濷	ioiy
坔	ioj
泴	iomn
沓	ion
畓	ionb
瀯	ioob
澇	iooc
濚	iood
濴	iooi
濙	iooo
淡	ioow
瀠	ioox
瀅	iooy
洮	ioqg
沯	ios
湉	iotm
沀	iovc
氼	iowg
凼	ioxl
党	ip
浑	ipaf
涟	ipaf
渾	ipaf
漣	ipaf
潌	ipaj
牚	ipal
営	ipbb
瀢	ipbm
滬	ipbv
学	ipck
労	ipct
敩	ipct
棠	ipd
栄	ipd
浨	ipd
淭	ipd
滨	ipew
溛	ipex
甞	ipfj
瀽	ipfl
黉	ipfw
淀	ipg
瀗	iphp
	ipii
泶	ipio
堂	ipj
坣	ipj
淙	ipji
漥	ipjj
涳	ipjl
浣	ipjq
溕	ipjs
澾	ipju
滱	ipjv
尝	ipjx
渲	ipkk
泞	ipkl
濱	ipkm
演	ipkw
泻	ipkx
瓽	ipky
蛍	ipl
漃	iplv
濄	ipmb
沉	ipmg
常	ipml
黨	ipmo
觉	ipmq
赏	ipmw
峃	ipmx
當	ipnb
渖	ipnl
劏	ipnn
溟	ipnw
濘	ippk
澝	ippm
滵	ippm
淧	ippt
浓	ipq
涴	ipqc
沈	ipqg
鲎	ipqk
鴬	ipqx
鸴	ipqx
瀉	ipro
涋	ipsu
淚	ipsu
湥	ipsu
浤	ipsx
涙	ipsy
	ipsy
泌	ipt
掌	iptg
漨	ipth
喾	iptj
浶	iptl
沁	ipu
澻	ipus
沪	ipv
涫	ipv
濵	ipvm
濅	ipvv
泬	ipw
溶	ipwb
深	ipwd
浫	ipwf
瀋	ipwn
沱	ipx
澠	ipx
洝	ipxk
嘗	ipxn
滓	ipyf
裳	ipyq
汦	iqag
涽	iqan
泜	iqay
泃	iqb
洺	iqb
浼	iqbq
潒	iqbs
瀺	iqby
溜	iqcn
澥	iqct
染	iqd
沕	iqe
淴	iqep
沵	iqi
泺	iqiw
漈	iqji
渔	iqk
澛	iqkn
盜	iqmn
涣	iqms
洵	iqn
溩	iqo
瀂	iqon
漁	iqow
濥	iqpw
淜	iqq
淊	iqrj
洈	iqsc
澹	iqsy
氿	iqt
泖	iqtc
滐	iqtd
淘	iqtm
汮	iqu
淗	iqud
泡	iqv
浄	iqvl
淝	iqvn
沒	iqvy
洶	iqwx
湚	iqxq
沟	iqxy
汐	iqy
汋	iqy
汍	iqy
汣	iqy
渹	iqy
州	ir
汌	ir
淵	ir
浌	irat
溾	irb
湺	irbd
潗	ird
渒	irfg
準	irfg
泭	irgy
湟	irh
湶	irio
湼	irjl
鼝	irjv
澙	irko
淮	irl
滌	irld
滺	irlp
滫	irlq
浟	irlt
洎	irm
淿	irml
泊	irn
濞	irnr
濮	irnu
潐	irow
淣	irqg
潟	irqo
滜	irsf
溴	irsu
澔	irtj
漗	irtp
渊	irud
澳	irus
澚	irux
沜	irv
洢	irvt
溲	irvy
溣	irwf
灚	irwq
沎	irx
漑	irxq
激	iryt
涖	iryu
沰	is
滣	isb
湎	isbj
沥	isct
涿	ise
浝	ise
渀	isff
濿	isfy
溽	isgy
浱	isj
涯	isjj
瀦	isjn
洿	isjx
渏	iskb
洊	islc
洏	ism
瀀	ismt
洦	isn
湹	isnj
淹	isnx
洃	isow
洧	isq
漘	isq
源	isri
渜	issy
泷	ist
瀧	ist
瀝	istl
汱	isu
潦	isui
厳	isvt
沷	isvy
湏	isw
浹	isww
漺	isww
沋	isx
汯	isxy
汰	isy
汏	isy
少	it
汑	itag
涐	itat
洛	itb
潪	itbn
渪	itby
汽	itc
汔	itcg
沲	itcl
涤	itd
汘	itfg
涶	itfk
潕	itfo
泩	ith
浲	ithl
潲	itiq
洙	itiw
浩	itj
澨	itjw
汻	itk
湃	itkh
湩	itkj
湰	itkt
汼	itl
泎	itlg
活	itm
潨	itmi
洫	itmn
瀩	itms
漡	itne
浰	itng
湫	itow
泛	itp
洗	itqg
灒	itqm
濳	itqn
鍌	itqw
潅	itrl
鋈	itsw
沃	itsy
滗	itta
洚	ittj
泈	itu
滊	itud
泘	ituk
溗	itux
瀄	itvc
潷	itvl
溮	itvm
汷	itw
泆	itwg
潻	itwi
塰	itxj
涹	itxk
泲	itxt
海	itxu
瀿	itxx
润	iu
灛	iubf
淃	iuc
沩	iucy
洣	iud
澖	iud
澊	iudg
湭	iudk
洴	iuf
渆	iufn
洋	iuh
润	iuh
潤	iuh
漛	iuio
泮	iuj
溠	iujl
澜	iuki
潧	iumn
潎	iumt
涧	iun
澗	iun
潽	iunn
湴	iunu
瀵	iunw
溔	iuow
涚	iuq
澬	iuqm
湔	iuqn
潾	iuqt
湵	iuqy
灁	iuri
渞	iurm
渕	iusn
浂	iusy
渼	iusy
濶	iutm
灍	iuuq
溈	iuvo
涕	iuvt
溓	iuw
溢	iuwm
潫	iux
溇	iuxk
漊	iuxk
濨	iuxp
溯	iuxq
滋	iuxx
潣	iuyg
漾	iuyi
瀁	iuyv
溤	iv
泯	ivag
渥	ivaj
湣	ivan
溉	ivaq
漒	ivbl
湋	ivbt
澼	ivby
汿	ivc
潺	ivcc
漏	ivdo
沑	ivf
涺	ivfb
澱	ivfm
浔	ivgy
渌	ivh
涨	ivha
渳	ivhd
澉	ivht
洆	ivik
灟	ivil
漽	ivit
涵	ivix
泾	ivj
堻	ivj
潯	ivjg
澅	ivjk
泽	ivjl
潳	ivjn
溌	ivjq
溊	ivjv
湀	ivks
澄	ivku
瀰	ivkw
津	ivl
濜	ivlm
潚	ivlr
湄	ivm
湧	ivmc
涌	ivmj
淈	ivmm
涮	ivmn
慂	ivmp
汜	ivp
浸	ivpv
泿	ivq
湑	ivq
泦	ivqt
沸	ivr
滩	ivrl
碆	ivs
滪	ivsw
澦	ivsw
浘	ivta
涒	ivtb
潏	ivtb
渘	ivtd
溺	ivuu
波	ivv
潑	ivvm
涰	ivvv
潠	ivvw
錃	ivw
決	ivwg
泥	ivx
埿	ivxj
婆	ivxk
泓	ivxy
汉	ivy
汊	ivy
沢	ivy
溞	ivyl
浕	ivyu
小	iw
淦	iw
汃	iw
洽	iwb
瀹	iwbf
涗	iwbq
瀲	iwbt
澰	iwbw
沧	iwc
潝	iwcc
梁	iwcd
浮	iwck
湓	iwcm
汾	iwco
粱	iwcu
沴	iwe
渰	iwf
汄	iwg
浖	iwgy
洤	iwh
尛	iwii
	iwii
	iwii
潋	iwit
尘	iwj
塗	iwj
濦	iwjp
渓	iwjw
浍	iwjx
湲	iwkv
潊	iwlv
尚	iwmb
淪	iwmf
灂	iwmg
幤	iwmm
澮	iwmn
漞	iwmq
覍	iwmq
敞	iwmt
氅	iwmt
潘	iwn
虩	iwnm
泠	iwp
涭	iwpv
肖	iwq
洕	iwq
削	iwqn
渝	iwqn
揱	iwqt
滔	iwrj
雀	iwrl
辉	iwsa
尜	iwsi
浠	iwsm
淆	iwsq
耀	iwsr
韑	iwst
黋	iwsw
兤	iwsw
光	iwsx
尖	iwsy
涂	iwt
少	iwt
劣	iwtc
淫	iwtj
省	iwtm
潙	iwto
毟	iwtt
漵	iwtw
湌	iwv
当	iwvh
淨	iwvl
溆	iwvy
浴	iwwb
瀸	iwwk
滏	iwwu
沦	iwx
滃	iwxc
浽	iwxk
汹	iwxl
鸂	iwxq
溪	iwxs
尐	iwy
浛	iwyb
滄	iwyb
淰	iwyp
汵	iwyv
治	ixb
洳	ixb
灉	ixbr
汝	ixk
淥	ixki
滍	ixkl
湽	ixkn
淄	ixnb
漅	ixnd
沇	ixqg
潍	ixrl
渗	ixse
洠	ixtl
涘	ixts
泼	ixty
浚	ixwt
沘	ixx
泑	ixxc
濼	ixxd
滲	ixxe
湝	ixxr
灤	ixyd
灣	ixyv
泤	ixyw
汒	iya
涪	iyb
滈	iybb
淳	iybc
涼	iybi
澶	iybk
湸	iybm
湻	iybn
滖	iybq
瀼	iybq
濠	iybs
潡	iybt
澟	iybt
瀛	iyby
汸	iyc
濟	iycr
澵	iyde
灖	iydn
瀙	iydq
漳	iyfg
灨	iyfm
渡	iyfv
瀇	iyfw
汶	iyg
注	iyh
乼	iyhc
泳	iyio
灋	iykx
汴	iylg
滳	iymb
滴	iymf
沆	iymg
瀤	iymq
湆	iyn
浏	iyng
潼	iynj
滝	iynx
瀌	iyow
渧	iypm
澺	iypu
滂	iypy
湇	iyq
滰	iyqg
济	iyr
済	iyr
液	iyry
浐	iys
滻	iyst
濓	iysw
游	iytc
浒	iytk
漩	iytv
泣	iyu
濂	iyuw
浪	iyv
溏	iyvb
漮	iyvi
滽	iyvl
滦	iywd
淬	iywf
滚	iywq
洂	iywr
灕	iywr
湙	iyws
滧	iywt
淤	iywu
湾	iywv
洨	iyww
漓	iywx
漉	iyx
淁	iyxk
滀	iyxn
淯	iyxq
流	iyxr
澈	iyxt
鎏	iyxw
泫	iyxx
瑬	iyxy
土	j
塸	jabb
域	jabk
城	jac
墭	jacm
垤	jaj
堿	jakb
墄	jali
堰	janx
壏	jatm
吉	jb
墠	jbbf
壧	jbbt
堮	jbbx
郆	jbc
翓	jbcc
劼	jbct
堌	jbfb
埕	jbh
喆	jbjb
嚞	jbjb
墤	jblm
埙	jbm
塤	jbm
埚	jbmw
臺	jbpa
袁	jbq
埍	jbq
欯	jbqw
鴶	jbqx
颉	jbsw
喜	jbub
嘉	jbub
嚭	jbub
囍	jbub
鼛	jbub
彭	jbue
鼙	jbuf
尌	jbug
鼚	jbuh
鼞	jbuj
噽	jbuk
壴	jbuk
蟚	jbul
鼜	jbul
瞽	jbum
熹	jbuo
憙	jbup
歖	jbuq
鼘	jbur
鼕	jbuu
鼟	jbuu
鼓	jbuv
甏	jbuy
韦	jc
壭	jc
韧	jccy
垜	jcd
场	jce
地	jcl
韫	jcnm
韨	jcsy
埏	jctl
韬	jcwr
圾	jcy
塛	jdd
壩	jdfq
塼	jdgy
堙	jdj
墂	jdji
墵	jdjx
墰	jdnf
壖	jdsm
埔	jdu
垳	jeg
圻	jek
坵	jek
垢	jekb
坂	jevy
坬	jex
坼	jey
墐	jfbh
壦	jfbr
墳	jffm
坩	jfj
壒	jfjm
墸	jfjn
墷	jfkj
埴	jfmh
壊	jfmq
填	jfmw
墘	jfnc
塻	jfns
墴	jfnw
墆	jfqm
埖	jfrx
墙	jfub
垬	jfw
塔	jfwb
塨	jfwi
塂	jfwv
堪	jfx
墈	jfxc
堞	jfxd
塃	jfyr
二	jg
邿	jgc
剺	jgic
孷	jgic
漦	jgii
釐	jgij
氂	jgit
犛	jgit
未	jgiw
嫠	jgix
亖	jgjg
亍	jgl
忈	jgpu
兘	jgqb
邧	jgqc
元	jgqg
坖	jgqj
刓	jgqn
黿	jgqp
顽	jgqs
鼋	jgqx
井	jgr
亓	jgr
刱	jgrc
汬	jgri
坓	jgrj
丼	jgry
辇	jgwa
邞	jgwc
鄻	jgwc
鄼	jgwc
椝	jgwd
槼	jgwd
夫	jgwg
賛	jgwm
替	jgwn
规	jgwq
鬶	jgwu
鬹	jgwu
嫢	jgwx
亏	jgx
亐	jgx
动	jgxc
叇	jgxi
魂	jgxr
叆	jgxv
云	jgxy
寺	jgy
垹	jhc
埲	jhjl
堾	jhn
埥	jhq
塐	jhx
壣	jhxx
示	ji
士	jiii
祘	jiji
埫	jimb
壋	jinb
垙	jisx
垱	jivh
墚	jiwd
礼	jix
圭	jj
郌	jjbv
邽	jjc
劸	jjct
鞤	jjgf
堼	jjgj
幇	jjgm
幫	jjgm
犎	jjgt
封	jjgy
垚	jjj
壵	jjj
翹	jjjc
堯	jjjs
墝	jjjs
顤	jjjs
卦	jjlg
堵	jjn
刲	jjng
恚	jjpu
鼃	jjpx
坃	jjqg
款	jjqw
壔	jjvg
隷	jjvi
墻	jjwb
堎	jjwt
圬	jjx
坛	jjxy
坷	jkb
堛	jkbn
塥	jkbu
圩	jkg
圢	jkl
圷	jklg
墕	jklo
堜	jkmi
埬	jkni
垣	jknk
垭	jknu
埂	jknw
坪	jkuk
坘	jkxk
坉	jkxx
工	jl
坫	jlb
塷	jlbo
邛	jlc
卭	jlc
垇	jlck
功	jlct
巭	jlcw
圤	jlg
汞	jlio
埗	jlit
垰	jljl
圵	jlk
埱	jlkv
巧	jlkx
瓨	jlky
址	jll
鞏	jlmf
聓	jlmh
蛩	jlml
跫	jlml
盐	jlmn
恐	jlmp
贡	jlmw
銎	jlmw
巬	jlmw
貢	jlmw
巩	jlmy
壚	jlnm
墟	jlnu
壉	jlse
项	jlsw
攻	jltw
垆	jlvd
垆	jlvt
觋	jlwq
巫	jlww
击	jlxl
坰	jmb
夁	jmbf
垛	jmd
坥	jmh
墿	jmju
垌	jmkb
堽	jmkl
塏	jmku
覿	jmmq
皾	jmmv
賣	jmmw
垷	jmqg
塴	jmqq
墔	jmrl
堓	jmsf
坱	jmsy
堸	jmtl
堈	jmum
坄	jmv
堝	jmvb
垲	jmvk
坝	jmw
垻	jmw
埧	jmw
埛	jmwb
埁	jmwv
圸	jmx
坍	jmy
塄	jmyc
者	jn
都	jnc
塌	jncc
翥	jncc
乽	jncg
堁	jnd
壜	jndx
斱	jnek
垾	jnfl
埘	jngy
埋	jnj
塒	jnjg
坦	jnk
場	jnke
堤	jnkl
坤	jnl
塭	jnmn
覩	jnmq
墁	jnmv
堣	jnmy
煮	jnow
埸	jnqe
堨	jnqw
墣	jnuh
堺	jnwr
堒	jnxx
堩	jokk
埮	joow
垗	joqg
灻	jow
塉	jowq
堚	jpaf
毂	jpam
壝	jpbm
埞	jpg
垨	jpgy
埪	jpjl
豰	jpjm
垸	jpjq
塜	jpjs
墶	jpju
塇	jpkk
坾	jpkl
螜	jpkl
彀	jpkm
觳	jpkm
嗀	jpkm
榖	jpkm
殼	jpkm
瑴	jpkm
瞉	jpkm
穀	jpkm
糓	jpkm
縠	jpkm
轂	jpkm
鷇	jpkm
嗀	jpkm
壸	jpkn
壼	jpkn
懿	jpkp
鷧	jpkq
壹	jpku
皼	jpkv
亄	jpkx
壳	jpmg
殻	jpmm
悫	jpmp
覟	jpmq
壶	jpnu
塓	jpnw
埦	jpqc
売	jpqg
槖	jpsd
塚	jpse
蠧	jpsl
堗	jpsu
垯	jpsy
垞	jpta
塳	jpth
塠	jptv
志	jpu
坹	jpw
塎	jpwb
堔	jpwd
坨	jpx
壱	jpx
垵	jpxk
坁	jqag
坻	jqay
坸	jqb
堍	jqby
塯	jqcn
圽	jqe
圥	jqg
埆	jqm
坞	jqo
塢	jqo
堋	jqq
垑	jqqy
埳	jqrj
垝	jqsc
均	jqu
鋆	jquw
垉	jqv
埩	jqvl
坎	jqw
圴	jqy
圳	jr
垧	jrb
塊	jrb
堢	jrbd
埤	jrfg
坿	jrgy
塮	jrgy
堭	jrh
塅	jrhm
堆	jrl
垍	jrm
堄	jrqg
垘	jrsu
墺	jrus
堠	jrvt
墽	jryt
坧	js
坜	jsct
堐	jsjj
堶	jsjq
垮	jsjx
坯	jsk
埼	jskb
坏	jsl
壥	jsmj
埯	jsnx
塬	jsri
堧	jssy
垅	jst
壠	jst
壢	jstl
坺	jsvy
埉	jsww
塽	jsww
圫	jtag
耊	jtaj
垎	jtb
塩	jtbm
圪	jtcg
孝	jtck
教	jtct
圲	jtfg
埵	jtfk
墲	jtfo
埄	jthl
耂	jtii
堹	jtkj
壎	jtko
考	jtkx
塲	jtne
耇	jtqb
垁	jts
墧	jtsb
耉	jttb
垀	jtuk
塖	jtux
垖	jtv
埠	jtvf
坆	jtw
老	jtx
耋	jtxa
耆	jtxn
耈	jtxq
耄	jtxt
圦	jty
埢	juc
報	jucv
墫	judg
壿	judg
瓡	juex
垪	juf
垟	juh
幸	juj
坢	juj
堘	juj
增	jumn
墹	jun
増	junn
漐	juqi
墊	juqj
蟄	juql
贄	juqm
慹	juqp
褺	juqq
鷙	juqq
壛	juqr
摯	juqt
騺	juqv
縶	juqx
執	juqy
謺	juqy
盩	jutm
墡	juub
塧	juwm
塿	juxk
赱	juy
专	jv
垊	jvag
壀	jvby
埭	jvio
墀	jvit
翿	jvjc
墛	jvjg
壽	jvjg
燾	jvjo
魗	jvjr
圮	jvk
墱	jvku
垏	jvl
壗	jvlm
堳	jvm
毊	jvmb
聲	jvmh
漀	jvmi
埇	jvmj
堀	jvmm
馨	jvmn
磬	jvms
罄	jvmt
殸	jvmv
鏧	jvmw
謦	jvmy
圯	jvp
埽	jvpm
埐	jvpv
垠	jvq
壻	jvq
坲	jvr
声	jvt
塀	jvuf
坡	jvv
墢	jvvm
块	jvwg
坭	jvx
走	jw
越	jwax
垥	jwb
趮	jwbd
趗	jwbl
郝	jwc
超	jwcb
趐	jwcc
垺	jwck
坋	jwco
趯	jwcr
赲	jwct
赧	jwcv
埰	jwd
赾	jwek
赶	jwfl
趞	jwfn
趪	jwfw
埒	jwgy
趣	jwhv
趟	jwib
趙	jwiq
赻	jwit
坴	jwj
趌	jwjb
勎	jwjc
勢	jwjc
槷	jwjd
赭	jwjn
熱	jwjo
燅	jwjo
鵱	jwjq
趬	jwjs
摰	jwjt
驇	jwjv
赫	jwjw
埶	jwjy
趚	jwki
趔	jwkn
趰	jwkw
赨	jwl
趈	jwlb
趠	jwlf
赴	jwlg
赪	jwlm
赬	jwlm
趓	jwmd
埨	jwmf
趄	jwmh
趉	jwmm
赸	jwmx
墦	jwn
墖	jwnb
趕	jwnf
趧	jwnl
趩	jwnw
趒	jwoq
坽	jwp
趤	jwps
鼀	jwpx
赿	jwqa
趂	jwqi
堬	jwqn
趍	jwqq
赹	jwqu
趜	jwqu
趋	jwqv
赥	jwqw
赼	jwqw
趨	jwqx
趆	jwqy
赤	jwr
圿	jwr
塪	jwrj
趡	jwrl
趭	jwro
頳	jwsw
趫	jwtb
趎	jwti
螫	jwtl
趱	jwtm
趀	jwtt
赦	jwtw
趦	jwub
趥	jwud
﨣	jwuf
趑	jwuq
趢	jwvh
起	jwvk
趘	jwvt
赮	jwvv
赽	jwvw
趛	jww
嗇	jwwb
﨏	jwwb
趁	jwwe
趖	jwwj
趝	jwwp
赺	jwwv
赵	jwwy
塕	jwxc
赳	jwxl
堫	jwxt
赯	jwyb
埝	jwyp
趇	jwyu
坅	jwyv
圠	jx
坮	jxb
唟	jxbx
却	jxc
刧	jxco
劫	jxct
叝	jxcv
刼	jxcy
弆	jxf
凷	jxl
盍	jxmn
刦	jxng
朅	jxnw
鼁	jxpx
堖	jxrw
毐	jxs
堟	jxse
埃	jxts
坶	jxu
埈	jxwt
坳	jxxc
墋	jxxe
堦	jxxr
塡	jxxw
去	jxy
壪	jxyv
圡	jy
培	jyb
塙	jybb
埻	jybc
墎	jybc
壇	jybk
壤	jybq
壕	jybs
墩	jybt
坊	jyc
垶	jyf
墇	jyfg
墌	jyfo
壙	jyfw
坟	jyg
墒	jymb
墑	jymf
坑	jymg
壞	jymq
堷	jyn
墥	jynj
塝	jypy
境	jyqg
圹	jys
垃	jyu
埌	jyv
塘	jyvb
垿	jyvc
墉	jyvl
埣	jywf
壌	jywq
塆	jywv
垴	jywx
塶	jyx
堉	jyxq
垓	jyxw
一	k
弐	kajg
武	kall
虣	kalm
鹉	kalq
貮	kamw
勅	kbic
整	kbil
赖	kbim
剌	kbin
慗	kbip
欶	kbiq
鵣	kbiq
鶒	kbiq
鷘	kbiq
頼	kbis
敕	kbit
束	kbiw
辢	kbiy
橐	kbld
蠹	kbll
囊	kblq
栆	kblu
叓	kblv
翮	kbmc
鬴	kbmd
鬺	kbme
鞷	kbmf
融	kbml
鬸	kbmn
鷊	kbmq
鹝	kbmq
鬷	kbmt
鬲	kbmu
畐	kbnb
副	kbnn
鶝	kbnq
豌	kbuc
豍	kbuf
豇	kbuj
豆	kbuk
剅	kbun
頭	kbus
毭	kbut
豏	kbuu
豉	kbuv
事	kbvl
剚	kbvn
吏	kbwy
趸	kcbl
劢	kcct
虿	kcl
万	kct
末	kd
膥	kdaw
唜	kdbx
开	kf
邢	kfc
形	kfe
刑	kfng
型	kfnj
烎	kfow
鳽	kfqx
雃	kfrl
于	kg
邘	kgc
盂	kgmn
夀	kkvg
丁	kl
丅	kl
可	klb
戨	klba
哥	klbb
歌	klbq
邒	klc
乤	klcg
下	klg
靕	klhq
鄢	klkc
焉	klko
正	kll
颪	klml
忑	klpu
鴊	klqx
夒	klrt
顶	klsw
政	kltw
亙	klvk
丐	klx
丏	klxc
曹	kmfn
棘	kmii
刺	kmin
鶫	kmiq
敇	kmit
枣	kmiu
柬	kmiw
再	kmj
巿	kml
帀	kml
両	kmmx
鳾	kmqx
	kmqx
兩	kmty
邴	kmwc
丙	kmwg
两	kmww
郦	kmyc
彨	kmye
彲	kmye
鹂	kmyq
婯	kmyx
丽	kmyy
畱	knan
専	kngy
琧	knhy
鶇	kniq
東	kniw
垩	knj
堊	knj
亘	knk
卝	knk
芈	knkj
畺	knkk
刯	knkn
茍	knkq
雈	knkr
蝁	knl
羋	knlj
晋	knn
曺	knn
戬	knna
鄑	knnc
恶	knpu
鵶	knqx
严	knt
亚	knu
亜	knu
亞	knu
郠	knwc
甦	knwt
更	knwy
画	knxl
叀	knxy
灭	kow
歹	kq
殘	kqaa
残	kqat
殫	kqbf
殒	kqbm
殛	kqck
歽	kqek
殜	kqfd
殣	kqfh
殱	kqfk
殖	kqfm
殑	kqfq
殏	kqgy
殝	kqht
殰	kqjm
殪	kqju
殐	kqki
殌	kqkj
殭	kqkk
殩	kqku
殂	kqmh
殃	kqms
殬	kqmu
殁	kqmv
劽	kqnc
列	kqng
殟	kqnm
烈	kqno
裂	kqnq
銐	kqnw
姴	kqnx
殯	kqpm
殡	kqpw
歾	kqqe
殉	kqqn
歿	kqqv
殦	kqqx
殠	kqrs
殎	kqsw
殗	kqsx
殇	kqte
歼	kqtf
殅	kqth
殊	kqti
殈	kqtm
殀	kqts
殚	kquf
殔	kqvi
肂	kqvl
殍	kqwc
殄	kqwe
殓	kqwi
殲	kqwk
飱	kqwv
餮	kqww
死	kqx
殆	kqxb
殕	kqyb
殧	kqys
卅	kr
丌	kr
吞	ksb
郉	ksfc
栞	ksfd
幵	ksfl
沗	ksio
忝	ksiw
蝅	kskl
蠺	kskl
蚕	ksl
昋	ksn
奣	ksnq
鴌	ksqx
无	ksx
天	ksy
丣	ktav
来	kud
平	kuk
赉	kumw
郏	kusc
刾	kusn
慭	kusp
颊	kuss
夹	kusy
亊	kuvl
五	kv
吾	kvb
郚	kvbc
敔	kvbt
戸	kvd
郪	kvlc
疌	kvll
鶈	kvlq
妻	kvlx
忢	kvpu
戸	kvt
夷	kvwg
鴺	kvwq
壐	kwmj
蠒	kwml
覼	kwmq
鸍	kwmq
爾	kwmw
璽	kwmy
丈	kwy
与	kx
丂	kx
瓰	kxcc
邷	kxcc
瓧	kxcf
瓩	kxcf
瓼	kxcj
甅	kxcj
瓸	kxcn
瓱	kxct
瓪	kxcv
瓲	kxcx
瓦	kxcy
坙	kxj
勁	kxjc
巠	kxjl
剄	kxjn
鵛	kxjq
巰	kxjr
頸	kxjs
互	kxk
欤	kxqw
攷	kxtw
屯	kxx
戩	kxxa
邨	kxxc
旾	kxxn
晉	kxxn
顿	kxxs
上	l
虐	laak
蜮	labk
鸆	labq
虞	labs
虏	lact
虨	lade
虗	laek
螹	laek
蛼	laf
虍	laii
蛭	laj
戲	laka
齾	lakl
覻	lakq
獻	laks
鬳	laku
蝛	lakx
甗	laky
蚜	lal
虥	lama
彪	lame
甝	lamf
虎	lamg
虘	lamh
虤	lamm
虪	lamm
贙	lamm
覤	lamq
覰	lamq
皻	lamv
戯	lana
戱	lana
勴	lanc
虜	lanc
盧	lanm
慮	lanp
觑	lanq
顱	lans
虚	lanu
虡	lanw
蝘	lanx
虙	lapt
虑	lapu
	laqt
	laqt
雐	larl
虧	larx
勮	lasc
豦	lase
劇	lasn
頥	lasw
蛲	lasx
蠮	latc
處	latm
歑	latq
虖	latu
蚷	lav
虔	layg
蟈	lbak
蛔	lbb
蟬	lbbf
蝈	lbhy
蜈	lbks
蚛	lbl
蜗	lbmw
蜖	lbnj
蝇	lbnx
蜎	lbq
蜠	lbtd
蛁	lcb
蛡	lcc
蛠	lccc
虸	lck
虵	lcl
凹	lclk
兕	lclq
蜢	lcmn
虭	lco
蠗	lcrl
蜓	lctj
蜒	lctl
蟉	lcwe
蚞	ld
蜥	ldek
螵	ldji
蟫	ldnf
蟪	ldpu
蠕	ldsm
蜅	ldu
蜙	ldwx
丯	le
蚯	lek
蚚	lek
螔	lelm
蛌	lex
蚸	ley
蛄	lfb
螼	lfbh
蠸	lfbr
蟖	lfek
蠂	lffd
蟦	lffm
蜞	lfh
蚶	lfj
螨	lfkw
虷	lfl
蠴	lfmj
蝧	lfms
蜹	lfmw
蠛	lfmy
蜡	lfn
蟆	lfns
蟥	lfnw
蠇	lfny
蝾	lfpd
蠓	lfps
蝴	lfq
螮	lfqm
蠘	lfrl
蠖	lfrv
蟒	lfsf
蝻	lfu
蟏	lfvr
蠨	lfvr
蚑	lfvy
蝶	lfxd
卜	lg
占	lgb
战	lgba
鹹	lgbb
梷	lgbd
鹾	lgbj
点	lgbo
觇	lgbq
奌	lgbs
頕	lgbs
鹻	lgbu
卣	lgbv
卤	lgbw
乩	lgbx
卥	lgby
上	lgk
尗	lgki
卡	lgkl
督	lgkm
忐	lgkp
裻	lgkq
叔	lgkv
仧	lgkw
錖	lgkw
卨	lgmb
盀	lgmn
欳	lgmq
鼑	lgmv
贞	lgmw
桌	lgnd
卓	lgnf
鵫	lgnq
蛷	lgoy
壑	lgpj
睿	lgpm
肻	lgpq
敹	lgpt
叡	lgpv
韰	lgqk
粲	lgqu
餐	lgqw
鳪	lgqx
歺	lgqy
卢	lgvd
鸬	lgvq
颅	lgvs
卢	lgvt
攴	lgvy
蚟	lh
蟶	lhbh
蜯	lhjl
蚌	lhl
蝽	lhn
蜻	lhq
螓	lhtd
螦	lhx
蝳	lhxu
虫	li
蟝	liad
丨	liii
螳	lij
蝋	limj
蟐	liml
蟷	linb
蛸	liq
频	lisw
步	lit
颦	litf
蛣	ljb
蟢	ljbb
蟛	ljbe
蛙	ljj
蟯	ljjs
虹	ljl
蝫	ljn
蚖	ljqg
蚨	ljwg
蛯	ljx
蜐	ljxc
螧	ljxn
丄	lk
蚵	lkb
蝠	lkbn
螎	lkbu
蚈	lkf
虶	lkg
虰	lkl
虾	lklg
凸	lklk
螬	lkmn
蛃	lkmw
蜽	lkmy
蛚	lkng
蝀	lkni
蝆	lknj
蚲	lkuk
蛱	lkus
蜨	lkvl
蛦	lkvw
蛵	lkxj
止	ll
翽	llac
歳	llai
劌	llan
顪	llas
歲	llat
歫	llav
蛅	llb
歬	lleu
歧	llfv
虲	llg
歵	llhm
颦	llif
频	llis
步	llit
歭	lljg
蟲	lll
歨	llll
歮	llll
蠱	lllm
蠦	llnm
肯	llq
頉	llsw
歱	lltj
辪	llty
齢	lluw
歯	llux
此	llx
呰	llxb
啙	llxb
柴	llxd
些	llxj
赀	llxm
鮆	llxo
觜	llxq
雌	llxr
砦	llxs
胔	llxw
鈭	llxw
飺	llxw
紫	llxx
訾	llxy
蛐	lmfk
虮	lmg
凣	lmg
蛆	lmh
蚺	lmj
蜩	lmjb
蚦	lmjg
蝐	lmjm
蠌	lmju
蠉	lmkq
螘	lmku
蠷	lmmr
蠼	lmmv
蠳	lmmx
蛊	lmn
蟔	lmo
螖	lmp
蚬	lmqg
蠋	lmql
蠵	lmrb
蝄	lmuy
蝸	lmvb
蛽	lmw
蚋	lmwg
蛧	lmww
蚒	lmy
旧	ln
蚎	ln
蜾	lnd
蝪	lnke
蝭	lnkl
蛳	lnkm
蝹	lnmn
蟃	lnmv
蠝	lnnn
蝿	lnnx
蚰	lno
蝟	lnq
蜴	lnqe
児	lnqg
蠍	lnqq
蝎	lnqw
螺	lnx
蜫	lnxx
蟧	looc
蠑	lood
螲	lpaj
蝊	lpg
螛	lphb
蟽	lpju
蝖	lpkk
蠙	lpkm
螾	lpkw
蝙	lpmf
螟	lpnw
蜿	lpqc
蜧	lpsu
螁	lpvq
蛇	lpx
蠅	lpx
蚏	lq
蚔	lqag
蚳	lqay
蚼	lqb
蟓	lqbs
蠏	lqct
蟂	lqd
蝜	lqmw
蜔	lqnb
螐	lqo
蛥	lqqy
蜭	lqrj
蛫	lqsc
蟾	lqsy
蜪	lqtm
蚐	lqu
蚫	lqv
虳	lqy
蜵	lr
蟘	lram
蚮	lray
螝	lrb
蝂	lrev
蜱	lrfg
蚹	lrgy
蝗	lrh
蜼	lrl
螩	lrld
蟭	lrow
螅	lrpu
蜺	lrqg
螑	lrsu
蟌	lrtp
蛜	lrvt
螋	lrvy
螕	lrwx
蝒	lsbj
蚅	lsc
蛖	lse
蠣	lsfy
蜄	lsj
蝰	lsjj
蚽	lsk
蛎	lskc
蟵	lskg
蛨	lsn
蛕	lsq
螈	lsri
蝡	lssy
蠬	lst
蟟	lsui
蟩	lsuq
蛂	lsvy
蝢	lsw
蛺	lsww
蚘	lsx
蚝	lta
虴	ltag
蛾	ltat
蜘	ltb
蛒	ltb
蝺	ltby
虼	ltcg
蜏	ltcp
蟱	ltfo
﨡	lth
蜂	lthl
蛛	ltiw
蝩	ltkj
蚱	ltlg
蛞	ltm
蟍	ltnd
蜊	ltng
蝮	ltnt
蟜	ltsb
蝌	ltuf
蜁	ltvl
螄	ltvm
蛈	ltwg
蜲	ltxk
蜷	luc
蝤	ludk
蛢	luf
蚪	lufg
蛘	luh
蝉	lunf
蜕	luq
蠀	luqm
蟻	luta
螏	luts
蟮	luub
螊	luw
螠	luwm
蜣	lux
蝼	luxk
螆	luxx
蚂	lv
螞	lv
蝍	lvc
蜛	lvfb
蠾	lvil
蜬	lvix
蛏	lvj
蟳	lvjg
蝦	lvjv
蚓	lvl
蟰	lvlr
蝞	lvm
蛹	lvmj
蚆	lvn
蛝	lvq
蝑	lvq
蝚	lvtd
蚾	lvv
蝃	lvvv
蟤	lvvw
蚗	lvwg
蚭	lvx
蚇	lvy
齿	lw
齖	lwal
蛤	lwb
齫	lwbd
龊	lwbl
蛻	lwbq
齞	lwbw
齶	lwbx
龆	lwcb
蜉	lwck
蚡	lwco
齽	lwdj
齼	lwdv
齭	lwee
齗	lwek
龂	lwek
齰	lwfn
齻	lwfw
齛	lwfx
蛶	lwgy
齱	lwhv
齒	lwii
龉	lwkb
蝯	lwkv
龇	lwlx
蜦	lwmf
龃	lwmh
蟠	lwn
齥	lwnt
齵	lwny
蛉	lwp
齳	lwpa
蟋	lwpu
齣	lwqb
蝓	lwqn
龅	lwqv
齺	lwqx
蚧	lwr
齨	lwrj
齯	lwrq
齮	lwsb
蜍	lwt
齕	lwtc
龁	lwtc
齚	lwtl
蟡	lwto
龋	lwty
齸	lwum
龌	lwva
龈	lwvq
龄	lwwp
齘	lwwr
蚥	lwwy
龀	lwx
齓	lwx
齔	lwx
齝	lwxb
螉	lwxc
螇	lwxs
蝬	lwxt
蚣	lwxy
蛿	lwyb
螥	lwyb
齴	lwye
蚙	lwyv
齩	lwyw
蠄	lwyx
虬	lx
蠟	lxbx
虯	lxl
蝝	lxse
蛑	lxtl
蚍	lxx
蚴	lxxc
蜌	lxxj
蝔	lxxr
蟣	lxxw
虻	lya
蟙	lyat
蜳	lybc
蝏	lybk
蟺	lybk
蠰	lybq
蠔	lybs
螂	lyc
蚄	lyc
蠐	lycr
蟑	lyfg
蟅	lyfo
蚊	lyg
蛀	lyh
蠩	lyjn
螪	lymb
蚢	lymg
蟀	lyof
螃	lypy
蛴	lyr
蝣	lytc
蠊	lyuw
蝷	lyux
蜋	lyv
螗	lyvb
蜶	lywf
蛟	lyww
螭	lywx
蚁	lywy
螰	lyx
蜟	lyxq
蚿	lyxx
同	m
瞘	mabb
眶	mah
眰	maj
贱	mat
眍	mawy
眓	max
冋	mb
矂	mbbd
瞣	mbbp
睏	mbd
睈	mbh
瞆	mblm
瞶	mblm
睊	mbq
眖	mbqg
眧	mcb
矅	mcrl
睷	mcvl
瞟	mdji
瞫	mdnf
矐	mdrl
睞	mdww
瞃	mefm
盺	mek
矀	memt
眽	meq
眅	mevy
瞛	mewl
冊	mf
睵	mfb
矔	mfbr
瞸	mffd
曲	mfk
鄷	mfkc
瞱	mfkj
豑	mfkt
豊	mfku
艶	mfkv
瞒	mfkw
盰	mfl
置	mfmh
矒	mfmm
巅	mfms
瞋	mfmw
瞞	mfmy
瞄	mfnb
刪	mfng
瞙	mfns
矇	mfps
矆	mfrv
睰	mfsb
農	mfsj
典	mfw
覥	mfwq
觍	mfwq
敟	mfwt
几	mg
朵	mgd
凩	mgd
剁	mgdn
凨	mgjx
凬	mgkn
夙	mgkq
凪	mgll
凧	mgml
鳯	mgqx
凰	mgrh
凮	mgsn
颬	mgta
颭	mgtb
颱	mgtb
颩	mgte
颺	mgte
飂	mgte
飉	mgti
飃	mgtj
風	mgtl
颾	mgtl
飍	mgtl
颲	mgtn
飀	mgtn
飅	mgtn
颷	mgto
飈	mgto
颸	mgtp
颮	mgtq
颵	mgtq
飇	mgts
颳	mgtt
颹	mgtt
飋	mgtt
颴	mgtv
颼	mgtv
颫	mgtw
颶	mgtw
颰	mgty
凲	mguw
凤	mgvy
飐	mgwb
飏	mgwe
飗	mgwn
飚	mgwo
飔	mgwp
飑	mgwq
飕	mgwv
飓	mgww
风	mgwy
凡	mgy
且	mh
助	mhct
眲	mhd
懸	mhip
縣	mhix
盽	mhl
瞔	mhmw
睶	mhn
刞	mhng
睛	mhq
鴡	mhqx
雎	mhrl
具	mhw
悬	mhxp
县	mhxy
目	mi
冈	miii
冂	miii
罓	miii
瞠	mij
矘	mimo
睄	miq
眇	mit
用	mj
周	mjb
瞦	mjbb
翢	mjbc
郮	mjbc
彫	mjbe
冔	mjbg
鵰	mjbq
雕	mjbr
冃	mjg
冄	mjg
眎	mji
冉	mjii
眛	mjiw
眭	mjj
冒	mjm
勖	mjmc
毷	mjmt
睹	mjn
冐	mjq
盶	mjqg
冕	mjqq
睦	mjwj
瞡	mjwq
睖	mjwt
甩	mjx
瞌	mjxm
眃	mjxy
赋	mkal
同	mkb
戙	mkba
眜	mkd
盱	mkg
盯	mkl
眄	mklc
眐	mkll
眪	mkmw
矖	mkmy
睐	mkud
睫	mkvl
眱	mkvw
盹	mkxx
巾	ml
帴	mlaa
幧	mlbd
幝	mlbf
幗	mlbk
帜	mlbw
帼	mlby
幖	mldj
幉	mlfd
帺	mlfh
幩	mlfm
幙	mlfs
幪	mlfs
幭	mlfy
帐	mlha
帱	mlhg
帻	mlhm
帩	mliq
幥	mlit
帏	mljc
幬	mljg
甴	mljg
幊	mljm
帾	mljn
円	mlk
帓	mlkd
帄	mlkl
幅	mlkn
帖	mllb
帧	mllm
帽	mlmm
帆	mlmy
幜	mlni
矑	mlnm
幌	mlns
幞	mlnu
幔	mlnv
幆	mlnw
帵	mlpc
幰	mlpp
帎	mlpq
幏	mlps
幎	mlpw
幨	mlqy
帷	mlrl
帕	mlrn
幒	mlrp
帿	mlrt
帪	mlsj
帞	mlsn
幁	mlsw
帗	mlsy
幯	mltc
帲	mltf
幠	mlto
帙	mltw
帡	mluf
幱	mlui
帨	mluq
幄	mlva
幈	mlvf
帊	mlvn
幃	mlvt
帔	mlvv
帢	mlwb
帉	mlwc
幡	mlwn
幍	mlwr
眦	mlx
幓	mlxe
幟	mlya
幛	mlyf
幮	mlyg
幢	mlyj
帹	mlyx
出	mm
睓	mmfw
睭	mmjb
祟	mmji
册	mmk
眮	mmkb
删	mmkn
瞐	mmm
煛	mmow
瞾	mmpj
鷪	mmpq
愳	mmpu
睍	mmqg
欪	mmqw
戵	mmra
瞿	mmrl
鸜	mmrq
氍	mmrt
矍	mmrv
瞁	mmsu
眏	mmsy
粜	mmud
糶	mmur
四	mn
罭	mnak
罥	mnbq
罧	mndd
罛	mnex
罟	mnfb
睅	mnfl
置	mnfm
罱	mnfu
羁	mnfv
刚	mng
皿	mnii
眔	mnio
罣	mnjj
罫	mnjl
署	mnjn
罴	mnjo
歝	mnjq
瞏	mnjq
鸅	mnjq
斁	mnjt
睪	mnju
罢	mnjx
翾	mnkc
罡	mnkl
睘	mnkq
鹮	mnkq
睤	mnkr
眒	mnl
罩	mnlf
罝	mnmh
鷶	mnmq
奰	mnms
買	mnmw
罪	mnnf
罼	mnnj
罳	mnnp
罹	mnor
睗	mnqe
斣	mnqf
蜀	mnql
劅	mnqn
罶	mnqn
歜	mnqq
鸀	mnqq
斀	mnqv
罗	mnqy
眾	mnrw
罘	mnsl
罽	mnsn
罨	mnsx
睲	mnth
瞨	mnuh
罾	mnun
罤	mnut
罵	mnv
罠	mnva
罻	mnvg
罞	mnvt
罬	mnvv
罦	mnwc
罖	mnwy
罺	mnxd
羄	mnxf
羆	mnxo
羂	mnxq
羅	mnxr
罷	mnxx
羉	mnxx
詈	mny
罸	mnyg
罜	mnyh
罿	mnyj
罚	mnyn
黑	mo
黬	moab
黖	moaq
黓	moay
黫	modj
黚	mofj
黩	mofs
黰	mofw
黮	mofx
墨	moj
黠	mojb
黷	mojm
黗	mokx
點	molb
黸	molm
黜	momm
睒	moow
黦	mopc
黕	mopq
眺	moqg
黟	moqq
黵	moqy
默	mosu
黤	mosx
黣	motx
黭	mowf
黔	mowv
黝	moxc
黪	moxe
黢	moxt
黥	moyi
黯	moyn
骨	mp
睴	mpaf
骮	mpay
髎	mpce
髆	mpdg
骵	mpdk
骺	mpeb
骷	mpfb
髒	mpff
骭	mpfl
瞎	mphb
睆	mpjq
髐	mpjs
骬	mpkg
睻	mpkk
眝	mpkl
矉	mpkm
瞚	mpkw
骾	mpkw
髗	mplm
骴	mplx
髑	mpml
體	mpmu
骰	mpmv
骪	mpmy
髁	mpnd
瞑	mpnw
髃	mpny
矃	mppk
髕	mppm
髓	mppq
髋	mppq
髄	mppq
髉	mppr
髂	mppt
髌	mppw
髖	mppy
睕	mpqc
眈	mpqg
骩	mpqt
骲	mpqv
鹘	mpqx
骶	mpqy
髀	mprf
睙	mpsu
顝	mpsw
骻	mpsx
骼	mptb
瞇	mpud
骿	mpuf
髊	mpuj
髅	mpux
骳	mpvv
骱	mpwr
骽	mpwx
髇	mpyb
髍	mpyd
骯	mpym
骸	mpyw
髈	mpyy
眀	mq
眂	mqag
睧	mqan
眡	mqay
眗	mqb
眳	mqb
睌	mqbq
覎	mqck
觃	mqck
覹	mqet
见	mqg
見	mqg
覞	mqmq
矎	mqmt
眴	mqn
眵	mqqy
瞻	mqsy
盷	mqu
睁	mqvl
覐	mqww
瞗	mqx
睥	mrfg
睢	mrl
瞧	mrow
矈	mrpy
矏	mrpy
睨	mrqg
睺	mrvt
瞍	mrvy
郹	msc
矋	msfy
睚	msjj
盎	msmn
鸯	msqx
眬	mst
矓	mst
狊	msu
瞭	msui
央	msy
眊	mta
睋	mtat
盵	mtcg
睡	mtfk
瞴	mtfo
矄	mtko
矁	mtop
瞅	mtow
眨	mtp
眣	mtwg
內	mty
睠	muc
眯	mud
眻	muh
瞤	muh
眫	muj
剛	mumn
岡	mumx
瞷	mun
瞯	muq
瞵	muqt
眹	musy
睇	muvt
瞜	muxk
	muxk
罔	muya
眠	mvag
睩	mvh
瞰	mvht
殳	mvii
矚	mvil
睱	mvjv
睽	mvks
瞪	mvku
冎	mvm
睸	mvm
咼	mvmb
剮	mvmn
旤	mvmq
歄	mvmq
囘	mvp
眼	mvq
瞲	mvtb
瞩	mvty
眤	mvx
贝	mw
賤	mwaa
贓	mwaa
蠈	mwal
贼	mwas
贱	mwat
冏	mwb
賗	mwbl
贃	mwbp
贶	mwbq
瞼	mwbw
郥	mwc
賿	mwce
貤	mwcl
盼	mwco
睬	mwd
贉	mwdf
赙	mwdg
眕	mwe
贩	mwev
贜	mwfa
賳	mwfb
購	mwfm
赎	mwfs
贎	mwfy
内	mwg
财	mwgt
赇	mwgy
账	mwha
賰	mwhn
	mwhq
	mwhq
貝	mwii
睑	mwik
贘	mwim
贖	mwjm
赌	mwjn
貦	mwjq
赋	mwkl
盻	mwkx
贴	mwlb
賙	mwmb
赒	mwmb
睔	mwmf
賵	mwmm
贔	mwmm
赑	mwmm
赗	mwmm
瞺	mwmn
鹦	mwmq
罂	mwmt
賏	mwmw
賟	mwmw
鑍	mwmw
婴	mwmx
甖	mwmy
譻	mwmy
赐	mwne
则	mwng
贌	mwnu
赕	mwoo
賱	mwpa
賝	mwpd
賩	mwpj
贮	mwpk
瞬	mwpt
賯	mwqc
睮	mwqn
购	mwqx
赡	mwqy
赈	mwsj
睎	mwsm
贿	mwsq
贆	mwss
贚	mwst
赂	mwtb
貹	mwth
賉	mwtm
贬	mwtp
败	mwtw
賆	mwuf
賹	mwum
赠	mwun
赚	mwuw
睜	mwvl
贐	mwvm
赆	mwvu
貱	mwvv
賶	mwwb
肉	mwwg
赊	mwwj
羀	mwwn
賖	mwwt
网	mwwy
贻	mwxb
瞈	mwxc
贂	mwxe
賐	mwxt
赔	mwyb
賥	mwyf
赃	mwyj
貥	mwym
赅	mwyw
賘	mwyy
山	mx
嵅	mxab
嶇	mxab
峫	mxac
峸	mxac
崭	mxae
岽	mxai
峌	mxaj
岈	mxal
嶜	mxan
峣	mxas
嵗	mxat
岠	mxav
岖	mxaw
崴	mxax
眙	mxb
嶯	mxba
嵓	mxbb
崮	mxbf
岲	mxbq
嶉	mxbr
巖	mxbt
巗	mxbt
崿	mxbx
邖	mxc
岧	mxcb
岹	mxcb
嵺	mxce
屶	mxco
屷	mxcp
嶍	mxcr
屴	mxct
嶐	mxct
岌	mxcy
嶘	mxda
崊	mxdd
嵀	mxdh
嵖	mxdk
嶿	mxds
峬	mxdu
崍	mxdw
崧	mxdx
崾	mxdx
嶀	mxdx
崻	mxeg
岓	mxek
岴	mxek
嵷	mxel
嵸	mxel
嶽	mxes
嶶	mxet
岅	mxev
嵂	mxev
岵	mxfb
崂	mxfc
嵘	mxfd
屽	mxfl
嵽	mxfm
嵌	mxfq
嶻	mxfr
巏	mxfr
巅	mxfs
巈	mxfu
岐	mxfv
嵮	mxfw
嶱	mxfw
嵁	mxfx
嶊	mxgr
崝	mxhq
巀	mxia
埊	mxij
崉	mxin
汖	mxio
峭	mxiq
巌	mxit
県	mxiw
峙	mxjg
屸	mxjl
岏	mxjq
崁	mxjq
嶢	mxjs
嶤	mxjs
崚	mxjt
峔	mxjx
岢	mxkb
岍	mxkf
崠	mxki
崬	mxki
崋	mxkj
峘	mxkk
崨	mxkl
颽	mxkl
凱	mxkm
嶆	mxkn
剴	mxkn
峛	mxkn
峢	mxkn
覬	mxkq
峡	mxks
巎	mxkt
敳	mxkt
崃	mxku
敱	mxkv
峓	mxkw
峺	mxkw
屿	mxkx
巇	mxla
岾	mxlb
峠	mxll
巘	mxls
巚	mxls
岗	mxm
峒	mxmb
岨	mxmh
嵐	mxml
崗	mxmm
崱	mxmn
嶵	mxmn
岘	mxmq
岟	mxms
嶩	mxms
嵦	mxmu
嶧	mxmu
岚	mxmw
屾	mxmx
岀	mxmx
巊	mxmx
崵	mxne
嵵	mxng
崼	mxnl
岫	mxno
崽	mxnp
岬	mxnp
嵔	mxnq
嶪	mxnu
嶫	mxnu
岿	mxnv
嵑	mxnw
崐	mxnx
崑	mxnx
嵎	mxny
巆	mxob
嶗	mxoc
嶸	mxod
嵴	mxoq
嵱	mxpb
崇	mxpj
崆	mxpj
岤	mxpw
岮	mxpx
峖	mxpx
峵	mxpx
岄	mxq
岣	mxqb
峁	mxqc
嵥	mxqd
岉	mxqe
峥	mxql
崅	mxqm
峋	mxqn
刿	mxqn
剻	mxqn
崏	mxqn
嵧	mxqn
嵨	mxqo
崩	mxqq
嶑	mxqs
嶰	mxqt
嶋	mxqx
嶌	mxqx
岁	mxqy
嵬	mxrb
嶲	mxrc
酅	mxrc
嵲	mxrd
崥	mxrf
崲	mxrh
崔	mxrl
矊	mxrm
岶	mxrn
嶕	mxro
嶣	mxro
峳	mxrt
嶼	mxrw
岩	mxs
屵	mxs
輋	mxsa
崎	mxsb
岸	mxsf
嶚	mxsi
嶛	mxsi
崖	mxsj
岯	mxsk
峏	mxsm
耑	mxsm
剬	mxsn
炭	mxso
峟	mxsq
嶡	mxsq
嶥	mxsq
歂	mxsq
嵟	mxsr
颛	mxss
巃	mxst
巄	mxst
鼎	mxsv
峽	mxsw
崸	mxsw
崦	mxsx
巁	mxsy
峨	mxta
峈	mxtb
峉	mxtb
嶠	mxtb
屹	mxtc
嵙	mxtf
峰	mxth
峼	mxtj
崜	mxtk
眸	mxtl
巋	mxtm
巑	mxtm
峲	mxtn
巍	mxtr
峤	mxtr
岆	mxts
嵊	mxtu
崣	mxtx
嶭	mxty
嶬	mxua
崷	mxud
嶟	mxug
嵯	mxuj
嶒	mxun
嵄	mxus
嶙	mxut
嵰	mxuw
嵝	mxux
嵫	mxux
嶁	mxux
巕	mxux
岷	mxva
峮	mxvb
崌	mxvf
嶎	mxvg
峄	mxvj
岂	mxvk
屺	mxvk
峍	mxvl
嵹	mxvl
凯	mxvm
嵋	mxvm
崛	mxvm
崫	mxvm
剀	mxvn
岜	mxvn
觊	mxvq
岪	mxvr
嶝	mxvu
岥	mxvv
崡	mxvx
崟	mxw
崯	mxw
峪	mxwb
岎	mxwc
嵡	mxwc
嶖	mxwc
崘	mxwf
崙	mxwf
峑	mxwh
崄	mxwi
峜	mxwl
崢	mxwl
嵛	mxwn
岭	mxwp
崤	mxwq
岕	mxwr
嵠	mxws
嶺	mxws
睃	mxwt
岑	mxwv
嶮	mxww
乢	mxx
岰	mxxc
眑	mxxc
嵾	mxxe
峅	mxxf
嶈	mxxg
崰	mxxn
巓	mxxs
峻	mxxt
嶷	mxxv
禸	mxy
訔	mxy
嵩	mxyb
崞	mxyc
嵃	mxye
嶂	mxyf
嵻	mxyi
嵉	mxyk
崹	mxym
峕	mxyn
嵼	mxyt
岦	mxyu
崀	mxyv
峐	mxyw
峧	mxyw
嵭	mxyy
丹	my
盳	mya
眆	myc
彤	mye
瞕	myfg
雘	myfv
矌	myfw
盿	myg
眿	myio
刐	myng
瞳	mynj
鴅	myqx
瞓	myr
瞊	myvb
睟	mywf
瞝	mywx
瞮	myxt
眩	myxx
是	n
晟	nac
晠	nac
暱	nafb
晊	naj
晓	nasx
昛	nav
煚	navo
田	nb
暺	nbbf
曮	nbbt
嬲	nbcc
疁	nbce
男	nbct
畈	nbev
畖	nbex
異	nbfw
畴	nbhg
畤	nbjg
疇	nbjg
畦	nbjj
畊	nbjr
畉	nbjw
疅	nbkk
町	nbkl
畏	nbkq
畀	nbkr
畘	nbmj
畕	nbnb
櫐	nbnd
畼	nbne
壘	nbnj
壨	nbnj
疉	nbnk
疊	nbnm
畾	nbnn
鸓	nbnq
礨	nbns
氎	nbnt
罍	nbnt
纍	nbnx
塁	nboj
疂	nbom
畹	nbpc
畳	nbpm
顋	nbps
思	nbpu
胃	nbq
畇	nbqu
鴫	nbqx
畂	nbqy
甽	nbr
畸	nbsb
盢	nbsm
畎	nbsu
略	nbtb
畽	nbtj
畋	nbtw
畮	nbtx
畔	nbuj
疄	nbut
畷	nbvv
畛	nbwe
界	nbwr
畟	nbwt
畭	nbwt
累	nbx
畯	nbxt
毗	nbxx
甿	nbya
疃	nbyj
畩	nbyq
畡	nbyw
昭	ncb
照	ncbo
旸	nce
旫	nco
曜	ncrl
毾	ncta
昅	ncy
果	nd
杲	nd
晽	ndd
晰	ndek
晒	ndg
暷	ndgy
曇	ndjx
敤	ndlv
曋	ndnf
褁	ndq
夥	ndqq
曤	ndrl
曘	ndsm
颗	ndsw
晡	ndu
昕	nek
昄	nevy
暰	newl
暀	neyh
非	nf
辈	nfaf
暵	nfbw
翡	nfcc
棐	nfd
暁	nffs
早	nfg
旪	nfg
畢	nfjl
鷝	nfjq
韭	nfk
曅	nfkj
曄	nfkj
旱	nfl
蜚	nfl
旰	nfl
暎	nfms
暪	nfmy
剕	nfng
暯	nfns
曂	nfnw
曚	nfps
悲	nfpu
曔	nfqt
猆	nfsu
奜	nfsy
靟	nfta
暔	nfu
曣	nfuo
晎	nfw
暴	nfwi
餥	nfwv
謈	nfwy
婓	nfxk
斐	nfyg
裴	nfyq
晣	ngek
刂	ngii
师	ngkm
帅	ngml
监	ngtm
临	ngtn
览	ngtq
鉴	ngtw
归	ngvh
坚	ngvj
贤	ngvm
肾	ngvq
紧	ngvx
竖	ngvy
时	ngy
旺	nh
朂	nhct
暳	nhhv
暙	nhn
晴	nhq
最	nhvy
日	ni
曰	niii
曭	nimo
晃	nisx
里	nj
圼	nj
暿	njbb
昻	njc
昮	njct
時	njgy
昧	njiw
晆	njj
曉	njjs
暑	njn
暏	njn
黒	njow
曀	njpu
黙	njso
野	njvc
墅	njvj
昙	njxy
旦	nk
曧	nkbl
鼌	nkbx
昩	nkd
旴	nkg
韪	nklj
是	nkll
鶗	nklq
题	nkls
尟	nklt
晸	nklt
韙	nklt
匙	nklx
暕	nkmi
昁	nkml
昞	nkmw
昺	nkmw
曬	nkmy
量	nknj
晅	nknk
鼂	nkpx
昜	nkqe
敭	nkqt
鴠	nkqx
昊	nksy
晤	nkvb
旽	nkxx
申	nl
曱	nl
畅	nlce
朄	nlki
暢	nlne
晫	nlnf
曥	nlnm
畃	nlqy
勗	nmct
晪	nmfw
晭	nmjb
曙	nmjn
曎	nmju
晍	nmkb
暟	nmku
愚	nmlp
顒	nmls
颙	nmls
禺	nmly
昢	nmm
昷	nmn
晛	nmqg
曓	nmsk
映	nmsy
鄤	nmvc
曼	nmvy
旵	nmx
曪	nmxr
昌	nn
昍	nn
暃	nnf
曝	nnfi
晘	nnfl
暘	nnke
晶	nnn
晿	nnn
曑	nnne
曡	nnnm
曟	nnns
曐	nnnt
焸	nnow
暥	nnpx
晹	nnqe
暍	nnqw
顕	nnsw
暒	nnth
显	nnu
曗	nnuh
暻	nnyi
由	no
邮	noc
暅	nokk
畁	nokr
甹	nokx
冑	nomj
晱	noow
胄	noq
晁	noqg
頔	nosw
炅	now
炚	now
甲	np
晕	npaf
晖	npaf
暈	npaf
暉	npaf
翈	npcc
晥	npjq
暄	npkk
暝	npnw
晼	npqc
鸭	npqx
曢	npsi
昈	npv
曃	npvi
晏	npxk
鷃	npxq
明	nq
昫	nqb
晚	nqbq
昂	nqc
易	nqe
昒	nqe
剔	nqen
惖	nqep
鶍	nqeq
敡	nqev
琞	nqhy
暩	nqji
盟	nqmn
晩	nqnq
煦	nqow
曌	nqpj
猒	nqsu
曕	nqsy
旯	nqt
昴	nqtc
曻	nqtj
昀	nqu
欥	nqw
歇	nqxq
毼	nqxt
曷	nqxw
旳	nqy
晌	nrb
晑	nrb
暞	nrd
暭	nrof
曍	nrof
晲	nrqg
暤	nrsf
晔	nrxf
曒	nryt
曞	nsfy
晨	nsj
晇	nsjx
晻	nsnx
鷐	nsqx
昦	nsr
昽	nst
曨	nst
暸	nsui
暊	nsw
昃	nswg
旲	nsy
戥	ntat
昇	ntf
星	nth
甠	nth
晧	ntj
旿	ntk
曛	ntko
晷	ntlb
昨	ntlg
昸	ntu
暣	ntud
昳	ntwg
晦	ntxu
业	nu
邺	nuc
斲	nuek
暛	nujl
暽	nuqt
曦	nuta
鄴	nuuc
黺	nuuc
黼	nuud
對	nuug
業	nuuh
菐	nuuh
黹	nuui
丵	nuuj
懟	nuup
鸈	nuuq
糳	nuuu
叢	nuuv
鑿	nuuw
凿	nuux
黻	nuuy
彂	nuvt
晜	nuvt
暐	nvbt
曯	nvil
暇	nvjv
暌	nvks
昲	nvr
曊	nvrm
昵	nvx
昐	nwco
昣	nwe
暖	nwkv
昤	nwp
曖	nwpt
暧	nwpv
晞	nwsm
暚	nwtm
暡	nwxc
昖	nwxy
晗	nwyb
昑	nwyv
电	nx
昪	nxf
妟	nxk
曳	nxt
曵	nxty
晙	nxwt
昆	nxx
歞	nxxq
鵾	nxxq
鹍	nxxq
顯	nxxs
曏	nxyc
暠	nybb
影	nybe
景	nybi
晾	nybi
曩	nybq
颢	nybs
暾	nybt
昉	nyc
昘	nyc
暲	nyfg
曠	nyfw
旻	nyg
旼	nyg
昹	nyio
暗	nyn
曈	nynj
旷	nys
暆	nytc
暶	nytv
昱	nyu
昗	nyw
晬	nywf
晈	nyww
晐	nyxw
昡	nyxx
昿	nyxy
快	o
慪	oabb
惐	oabk
惭	oaek
悈	oaf
恇	oah
恎	oaj
恜	oajl
憾	oakp
惬	oaks
慽	oali
愝	oanx
憯	oaqn
愜	oasw
烧	oasx
懢	oatm
怇	oav
慳	oavj
怄	oawy
怴	oax
慖	obak
恛	obb
懆	obbd
憚	obbf
愕	obbx
悃	obd
悜	obh
悮	obks
忡	obl
愦	oblm
愪	obm
悁	obq
怳	obqg
悒	obvn
怾	obw
慍	obwm
悞	obxs
怊	ocb
恊	occc
愶	occq
忆	ocg
忚	ocl
忉	oco
慴	ocrn
憜	ocsq
忇	oct
憀	ocwe
忣	ocy
惏	odd
慄	odd
憷	oddv
恓	odg
愽	odgy
慱	odgy
慓	odji
憛	odnf
憓	odpu
懦	odsm
悑	odu
憟	odud
怵	ody
懫	oeem
忻	oek
惞	oeqw
怙	ofb
懄	ofbc
慬	ofbh
懽	ofbr
愅	off
愤	offm
忓	ofl
烘	ofm
懵	ofmm
懜	ofmq
愥	ofms
慎	ofmw
慲	ofmy
懱	ofmy
惜	ofn
愺	ofnf
懴	ofnk
慔	ofns
悖	ofpc
懞	ofps
懥	ofpv
憽	ofqp
懂	oftj
忮	ofvy
怈	ofx
愖	ofx
惵	ofxd
恾	ofya
慌	ofyr
忖	ogy
忹	oh
怅	oha
悵	oha
懾	ohhh
懳	ohhp
情	ohq
慠	ohtw
慑	ohvv
愫	ohx
忄	oiii
憆	oij
惝	oimb
戃	oimo
悄	oiq
恍	oisx
悩	oiwx
恄	ojb
懛	ojba
憘	ojbb
憉	ojbe
恃	ojgy
怽	ojiw
憢	ojjs
愩	ojmw
忨	ojqg
悻	ojuj
懤	ojvg
懎	ojwb
懗	ojww
恅	ojx
恸	ojxc
愭	ojxn
怯	ojxy
悚	okbi
懒	okbm
愊	okbn
忊	okl
恆	oklk
怔	okll
慒	okmn
怲	okmw
恒	oknk
悿	oksi
怃	oksx
怦	okuk
悟	okvb
恞	okvw
悽	okvx
忳	okxx
怗	olb
悼	olnf
憈	olnu
懅	olse
憹	omfs
怚	omh
惆	omjb
懌	omju
恫	omkb
懁	omkq
愷	omku
懼	ommr
戄	ommv
怬	omn
恻	omng
愲	omp
悓	omqg
慛	omrl
惴	omsm
怏	omsy
惘	omuy
恺	omvk
惧	omw
忛	omy
愣	omyc
惈	ond
悱	onf
懪	onfi
悍	onfl
愰	onis
悝	onj
怛	onk
愓	onke
惿	onkl
愄	onkq
愠	onmn
慢	onmv
怞	ono
愢	onpu
惕	onqe
愒	onqw
惺	onth
悭	onvj
惃	onxx
憬	onyi
憦	oooc
惔	ooow
恌	ooqg
恽	opaf
悰	opji
悾	opjl
愃	opkk
惼	opmf
慏	opnw
懧	oppk
惋	opqc
忱	opqg
悷	opsu
怭	opt
愘	optb
慥	optj
悺	opv
愹	opwb
憴	opx
忯	oqag
惛	oqan
怟	oqay
怐	oqb
悗	oqbq
懰	oqcn
懈	oqct
惚	oqep
忰	oqfg
兆	oqg
憏	oqji
鼗	oqjv
覜	oqmq
愌	oqms
恂	oqn
惸	oqnc
鴵	oqqx
恀	oqqy
惂	oqrj
恑	oqsc
頫	oqsw
憺	oqsy
怉	oqv
	oqvh
忺	oqw
恟	oqwx
	oqxx
愧	orb
恦	orb
恘	ord
楽	ord
惶	orh
懙	orkw
惟	orl
懏	orlc
怕	orn
憔	orow
憁	ortp
懊	orus
愯	orvy
憿	oryt
愐	osbj
墯	osjj
惰	osjq
恗	osjx
怌	osk
怀	osl
恠	oslj
怖	osml
懮	osmt
懨	osns
恢	osow
恹	ossu
愞	ossy
憭	osui
悏	osww
慡	osww
忧	osx
忕	osy
忲	osy
恪	otb
忾	otc
忔	otcg
悸	otck
忏	otfg
憮	otfo
性	oth
悎	otj
忤	otk
慟	otkc
憡	otki
怍	otlg
恬	otm
恤	otmn
慯	otne
悧	otng
愎	otnt
愀	otow
憍	otsb
愾	otud
怢	otwg
悔	otxu
惓	ouc
恲	ouf
怑	ouj
慻	oum
憎	oumn
惮	ounf
懻	ounw
悦	ouq
憪	ouq
憐	ouqt
愱	outs
悌	ouvt
慊	ouw
慺	ouxk
悯	ouyg
懩	ouyv
怋	ovag
惽	ovan
慨	ovaq
愇	ovbt
忬	ovc
忸	ovf
怪	ovj
憳	ovjg
怿	ovjl
忋	ovk
憕	ovku
愑	ovmc
悀	ovmj
恨	ovq
怫	ovr
憰	ovtb
愵	ovuu
怶	ovv
惙	ovvv
快	ovwg
怩	ovx
慅	ovyl
惤	ovyx
火	ow
惍	ow
烥	owa
熰	owab
煘	owab
炼	owai
烒	owaj
熞	owaj
爁	owam
熸	owan
爦	owaq
烧	owas
炬	owav
恰	owb
焒	owbb
煰	owbb
燥	owbd
燀	owbf
烟	owbg
熅	owbm
熉	owbm
煾	owbp
悅	owbq
炾	owbq
焆	owbq
炽	owbw
怆	owc
邩	owc
炤	owcb
炀	owce
灺	owcl
烻	owcl
燲	owcm
灱	owco
熁	owcq
熠	owcr
烶	owct
煡	owcv
熤	owcy
炑	owd
爩	owde
燂	owdf
煿	owdg
煙	owdj
熛	owdj
烞	owdl
燸	owds
烳	owdu
燯	owdw
爧	owdw
炢	owdy
烆	oweg
炘	owek
焮	oweq
烐	oweu
炍	owev
灷	owf
煤	owfd
燍	owfe
煂	owff
爤	owfi
燁	owfj
爡	owfl
煹	owfm
燌	owfm
焟	owfn
爑	owfo
燪	owfp
煳	owfq
爟	owfr
煐	owfs
焼	owfs
煵	owfu
烘	owfw
煁	owfx
燤	owfy
恮	owh
炐	owhl
灬	owii
爣	owim
焇	owiq
熦	owir
炒	owit
灶	owj
熺	owjb
炜	owjc
燽	owjg
烓	owjj
灴	owjl
熆	owjm
熕	owjm
懚	owjp
燒	owjs
焃	owjw
爀	owjw
烤	owjx
焐	owkb
煉	owki
烴	owkj
烜	owkk
灯	owkl
煏	owkn
愋	owkv
炳	owkw
炖	owkx
烛	owl
炶	owlb
焯	owlf
爞	owll
爐	owlm
爈	owlp
燦	owlu
爘	owlw
炯	owmb
烿	owme
惀	owmf
爅	owmj
煈	owml
燭	owml
炪	owmm
焵	owmm
懀	owmn
焨	owmq
熣	owmr
爠	owmr
炴	owms
煓	owms
燶	owms
燡	owmu
炈	owmv
灿	owmx
焹	owmy
憣	own
畑	ownb
焬	owne
煬	owne
焊	ownf
灲	owng
爆	owni
熚	ownj
爗	ownj
炟	ownk
煶	ownl
煴	ownm
焻	ownn
燳	owno
炠	ownp
煨	ownq
熀	owns
煋	ownt
熳	ownv
熼	ownw
焜	ownx
煜	owny
煔	owob
營	owob
郯	owoc
榮	owod
檾	owod
燊	owod
爃	owod
醟	owod
煢	owof
滎	owoi
塋	owoj
烾	owoj
禜	owoj
螢	owol
飊	owol
嵤	owom
焭	owom
剡	owon
焱	owoo
憥	owop
	owop
欻	owoq
歘	owoq
烑	owoq
膋	owoq
褮	owoq
覢	owoq
覮	owoq
鶑	owoq
鶯	owoq
顃	owos
顲	owos
犖	owot
罃	owot
敥	owov
炎	owow
嫈	owox
縈	owox
瑩	owoy
甇	owoy
謍	owoy
怜	owp
烢	owpa
煇	owpa
熔	owpb
煽	owpc
煸	owpf
熢	owph
爎	owpi
焢	owpj
煊	owpk
熥	owpm
烷	owpq
燧	owps
懓	owpt
燵	owpu
炉	owpv
煺	owpv
焪	owpv
熩	owpv
熐	owpw
炨	owpx
脊	owq
灮	owqg
烁	owqi
愉	owqn
熘	owqn
焔	owqn
焝	owqn
燃	owqo
焩	owqq
鶺	owqq
鹡	owqq
焰	owqr
焕	owqs
炮	owqv
炊	owqw
煼	owqx
灼	owqy
忦	owr
烌	owrd
烨	owrf
煌	owrh
慆	owrj
焳	owrl
煅	owrm
燋	owro
熄	owrp
燠	owrs
燩	owrt
炛	owrx
炻	ows
烼	owse
燎	owsi
煃	owsj
炋	owsl
爏	owsl
悕	owsm
烣	owso
烠	owsq
煗	owss
爖	owst
烦	owsw
恡	owsx
炦	owsy
爄	owsy
悇	owt
灹	owta
烙	owtb
炧	owtc
爋	owtc
秌	owtd
烽	owth
焅	owtj
煄	owtj
炸	owtl
愮	owtm
烅	owtm
煍	owto
燻	owto
烍	owtq
熪	owtq
烀	owtu
炇	owtw
烸	owtx
炿	owty
燨	owua
爔	owua
煪	owud
炓	owuf
燇	owug
烂	owuh
烊	owuh
爛	owui
熷	owun
焖	owup
燗	owuq
爓	owur
烪	owus
煫	owus
焍	owut
燐	owut
熌	owuw
熑	owuw
熡	owux
燘	owuy
焗	owvb
燏	owvb
煣	owvd
炄	owvf
燖	owvg
烃	owvj
爥	owvl
煀	owvm
煝	owvm
燼	owvm
炥	owvr
熽	owvr
煒	owvt
烬	owvu
煆	owvv
炔	owvw
焓	owwb
炝	owwc
爚	owwf
爝	owwg
烇	owwh
懺	owwk
烯	owwm
燔	owwn
炩	owwp
焧	owwp
焾	owwp
炌	owwr
熖	owwr
熎	owwt
燰	owwt
煖	owwv
烩	owwx
炲	owxb
慃	owxc
爍	owxd
忷	owxl
恱	owxq
煯	owxr
慀	owxs
惾	owxt
焌	owxt
爉	owxx
忪	owxy
熾	owya
焙	owyb
熵	owyb
愴	owyb
煻	owyb
熇	owyb
焞	owyc
燺	owyd
焠	owyf
炆	owyg
炷	owyh
燑	owyj
燷	owyj
炞	owyl
炕	owym
熫	owyo
爊	owyo
爕	owyo
惗	owyp
燱	owyp
焴	owyq
爙	owyq
夑	owyt
燉	owyt
燣	owyt
燫	owyu
燮	owyv
烄	owyw
烗	owyw
焿	owyw
爌	owyw
炫	owyx
焲	owyy
怡	oxb
惯	oxmw
恉	oxn
惱	oxrw
惨	oxse
恈	oxtl
懝	oxtv
怓	oxvy
悛	oxwt
怮	oxxc
慘	oxxe
悂	oxxj
愼	oxxw
忙	oya
悋	oyb
惇	oybc
悙	oybc
惊	oybi
懔	oybj
憻	oybk
懹	oybq
憱	oybs
憞	oybt
懍	oybt
懠	oycr
戂	oydn
懡	oydx
慞	oyfg
懭	oyfw
忟	oyg
怺	oyio
惦	oylb
忭	oylg
忼	oymg
懐	oymq
懷	oymq
愔	oyn
憧	oynj
憶	oypu
悢	oyv
慷	oyvi
慵	oyvl
悴	oywf
恔	oyww
恼	oywx
慉	oyxn
怰	oyxx
这	p
连	paf
連	paf
迓	pal
迴	pbb
遌	pbbx
遻	pbbx
逞	pbh
迚	pbl
遗	pblm
遣	pblv
逥	pbnj
辽	pc
迢	pcb
迦	pcb
迅	pcfg
逊	pciw
迆	pcl
辺	pco
辸	pcp
边	pct
窿	pctt
遜	pctx
﨤	pcy
迺	pdg
逎	pdk
遷	pdsv
逋	pdu
逨	pdww
述	pdy
鶐	pdyq
遁	pefm
逛	peh
逓	pejm
近	pek
逅	pekb
遞	pelm
逖	peow
返	pevy
辻	pfg
迀	pfl
遘	pfmj
逪	pfn
邁	pfny
遰	pfqm
逽	pfsb
遖	pfu
遳	pfwj
迣	pfx
定	pg
宦	pga
宧	pga
宬	pgac
室	pgaj
宫	pgbb
宲	pgbd
宮	pgbr
宺	pgbr
寥	pgce
字	pgck
宋	pgd
寭	pgdp
寙	pgee
逝	pgek
宾	pgew
寋	pgfc
寨	pgfd
塞	pgfj
蹇	pgfl
赛	pgfm
宽	pgfq
褰	pgfq
寛	pgfq
鶱	pgfq
寞	pgfs
搴	pgft
寒	pgfu
骞	pgfv
寘	pgfw
謇	pgfy
守	pggy
害	pghb
豁	pghb
寳	pghm
寶	pghm
割	pghn
憲	pghp
寈	pghq
鶷	pghq
寚	pght
寷	pghu
実	pghw
宝	pghy
宀	pgii
宵	pgiq
寖	pgiv
宯	pgjc
宗	pgji
崈	pgjm
賨	pgjm
完	pgjq
宑	pgjr
寇	pgjv
宼	pgjx
戭	pgka
翧	pgkc
宇	pgkg
宣	pgkk
宁	pgkl
賓	pgkm
富	pgkn
顮	pgks
寅	pgkw
宐	pglk
寊	pglm
寂	pglv
宂	pgmg
宜	pgmh
寰	pgmq
审	pgnl
宙	pgno
宴	pgnx
寓	pgny
宨	pgoq
叜	pgov
灾	pgow
逑	pgoy
寧	pgpk
蜜	pgpl
密	pgpm
甯	pgpm
寍	pgpm
寗	pgpm
鸋	pgpq
宓	pgpt
宛	pgqc
察	pgqj
剜	pgqn
惌	pgqp
鵷	pgqq
鹓	pgqq
寏	pgqs
宄	pgqt
寃	pgqy
寯	pgrc
宱	pgrl
寉	pgrl
宿	pgrn
寫	pgro
寑	pgrv
宕	pgs
寄	pgsb
寡	pgsc
家	pgse
寮	pgsi
宸	pgsj
寕	pgsk
宥	pgsq
宠	pgst
宊	pgsu
顁	pgsw
宏	pgsx
宅	pgta
客	pgtb
逰	pgtc
牢	pgtl
愙	pgtp
宪	pgtq
额	pgts
宩	pgud
宻	pgum
实	pgus
寝	pguv
寠	pgux
官	pgv
宭	pgvb
賔	pgvm
悹	pgvp
宆	pgvx
宖	pgvx
宷	pgwd
寀	pgwd
審	pgwn
寪	pgwo
覾	pgwq
它	pgx
寤	pgxb
案	pgxd
鞌	pgxf
寐	pgxi
安	pgxk
實	pgxm
鴳	pgxq
頞	pgxs
寢	pgxv
寲	pgxv
寎	pgxw
寣	pgxy
过	pgy
宰	pgyf
宔	pgyh
寴	pgyq
宍	pgyw
迋	ph
遨	phtw
之	pi
辶	piii
逤	piit
逍	piq
迼	pjb
遠	pjbq
违	pjc
逇	pjcl
遶	pjjs
远	pjqg
进	pjr
達	pjuh
逹	pjuj
逵	pjwj
迃	pjx
逺	pjxq
运	pjxy
辷	pk
速	pkbi
逼	pkbn
遬	pkbq
遫	pkbt
逗	pkbu
迈	pkct
迂	pkg
迊	pkml
遭	pkmn
逦	pkmy
迾	pkng
迗	pksy
逜	pkvb
邇	pkww
逕	pkxj
迍	pkxx
迠	plb
逌	plbv
遉	plmw
逴	plnf
遽	plse
迥	pmb
遝	pmio
週	pmjb
迵	pmkb
還	pmkq
逻	pmqy
遄	pmsm
過	pmvb
辿	pmx
邏	pmxr
遢	pncc
逿	pnke
遈	pnkl
迧	pnl
遇	pnmy
迪	pno
逷	pnqe
遏	pnqw
暹	pnrl
逃	poqg
郓	ppac
军	ppaf
鶤	ppaq
顐	ppas
皲	ppav
冧	ppdd
冪	ppfm
冣	pphv
冖	ppii
冠	ppjg
冡	ppjs
冦	ppjv
冨	ppkn
写	ppkx
遍	ppmf
冗	ppmg
冝	ppmh
鼏	ppmv
冚	ppmx
鄍	ppnc
幂	ppnm
鼆	ppnp
覭	ppnq
冥	ppnw
农	ppq
肎	ppq
邥	ppqc
冘	ppqg
沊	ppqi
鸩	ppqq
冤	ppqy
隺	pprl
冩	ppro
鹤	pprq
冟	pprx
冢	ppse
宓	ppt
蜜	pptl
密	pptm
冞	ppud
邃	ppus
逭	ppv
	ppw
罙	ppwd
罕	ppwf
迱	ppx
迌	pq
逸	pqby
迎	pqc
遛	pqcn
邂	pqct
迩	pqi
迯	pqlg
迿	pqn
迻	pqqy
遯	pqse
遙	pqtm
邎	pqyx
逈	prb
遑	prh
進	prl
迫	prn
邉	prpb
邊	prpy
遚	prvy
邀	pryt
逐	pse
逩	psff
遀	psjq
还	psl
迶	psq
迖	psu
遼	psui
达	psy
迏	psy
必	pt
迄	ptcg
迤	ptcl
透	ptcp
迁	ptfg
逢	pthl
造	ptj
遾	ptjw
迕	ptk
逬	ptkf
迮	ptlg
适	ptm
邍	ptnv
选	ptqg
邌	ptqw
逄	pttj
追	ptv
迭	ptwg
逶	ptxk
込	pty
心	pu
裓	puaf
襤	puam
褗	puax
吢	pub
裍	pubd
襙	pubd
襌	pubf
裀	pubg
裎	pubh
衶	publ
	pubm
	pubm
裐	pubq
袑	pucb
衪	pucl
初	puco
褶	pucr
衱	pucy
迷	pud
遵	pudg
襟	pudj
遒	pudk
襦	puds
襻	pudt
補	pudu
褼	pudv
衫	pue
裄	pueg
褷	puel
褫	puem
迸	puf
褋	pufd
褀	pufh
襽	pufi
衦	pufl
襺	pufl
褠	pufm
衼	pufv
褡	pufw
袣	pufx
襼	pufx
襔	pufy
襪	pufy
衬	pugy
襵	puhh
襀	puhm
裱	puhq
褉	puhs
褝	puif
衤	puii
襠	puin
裆	puiv
袺	pujb
袆	pujc
袿	pujj
褂	pujl
襩	pujm
褚	pujn
褤	pujq
襓	pujs
襭	pujs
裬	pujt
衭	pujw
袪	pujx
褹	pujy
袔	pukb
袜	pukd
衧	pukg
襋	puki
襰	pukm
褔	pukn
褿	pukn
裋	puku
襧	pukw
褄	pukx
裲	puky
襹	puky
袩	pulb
补	pulg
裃	pull
裭	pulm
褃	pulq
裯	pumb
袓	pumh
衻	pumj
袡	pumj
襡	puml
袦	pumm
褍	pums
襛	pums
襗	pumu
衲	pumw
襬	pumx
袇	pumy
衵	pun
褟	punc
裸	pund
裼	pune
裶	punf
襨	pung
襮	puni
裡	punj
襅	punj
袒	punk
褆	punl
褴	punm
裮	punn
袖	puno
襆	punu
襊	punv
褐	punw
裩	punx
裧	puoo
裢	pupa
褣	pupb
橤	pupd
褊	pupf
惢	pupp
衴	pupq
襚	pups
袐	pupt
褪	pupv
袕	pupw
繠	pupx
袉	pupx
衹	puqa
袧	puqb
袳	puqq
襐	puqs
遴	puqt
袀	puqu
袍	puqv
袛	puqy
襜	puqy
裫	pur
噵	purb
褓	purd
裨	purf
導	purg
袝	purg
裑	purh
道	purm
袙	purn
襣	purr
袱	purs
袵	purt
襷	purt
襥	puru
袥	pus
裿	pusb
袸	pusc
遂	puse
褥	pusg
袏	pusj
裖	pusj
袻	pusm
袹	pusn
襫	pusn
襱	pust
裌	pusw
袴	pusx
裺	pusx
送	pusy
必	put
袼	putb
袘	putc
邲	putc
袮	puti
袾	puti
衽	putj
裇	putm
襸	putm
覕	putq
鴓	putq
袄	puts
袶	putt
複	putt
袟	putw
裷	puuc
襕	puui
襴	puui
袢	puuj
裥	puun
褙	puuq
襒	puut
褛	puux
裙	puvb
褬	puvd
裾	puvf
襑	puvg
襁	puvl
襏	puvm
裉	puvq
递	puvt
被	puvv
裰	puvv
袂	puvw
衩	puvy
裕	puwb
袷	puwb
衯	puwc
袗	puwe
裣	puwi
襳	puwk
褕	puwn
襎	puwn
襘	puwn
袊	puwp
衸	puwr
衿	puwv
襝	puww
衳	puwx
袽	puxb
袎	puxc
襂	puxe
遱	puxk
逆	puxl
遡	puxq
褖	puxs
褦	puxx
袯	puxy
裤	puya
襢	puyk
褅	puym
褯	puym
襯	puyq
裗	puyr
袨	puyx
褵	puyx
户	pv
遤	pv
啔	pvab
肈	pvav
启	pvb
啟	pvbt
違	pvbt
扈	pvbv
避	pvby
扇	pvcc
戹	pvcg
迉	pvd
逯	pvh
肩	pvii
逮	pvio
遲	pvit
迳	pvj
遐	pvjv
邆	pvku
扂	pvlb
扃	pvmb
翩	pvmc
扁	pvmf
通	pvmj
帍	pvml
鶣	pvmq
騗	pvmv
甂	pvmy
扉	pvnf
扊	pvoo
退	pvq
扅	pvqq
鳸	pvqx
鵳	pvqx
扄	pvrb
雇	pvrl
顧	pvrs
戾	pvsu
顅	pvsw
戻	pvsy
迉	pvt
啓	pvtb
遹	pvtb
棨	pvtd
晵	pvtn
肇	pvtv
綮	pvtx
戽	pvuf
遅	pvuh
肁	pvvl
焈	pvvo
戺	pvvp
逫	pvvv
選	pvvw
迡	pvx
迟	pvy
房	pvyc
遟	pvyf
扆	pvyq
穴	pw
窃	pwac
窒	pwaj
窢	pwak
穿	pwal
窜	pwbl
窝	pwbw
穵	pwcg
穷	pwct
窿	pwct
穼	pwd
窳	pwee
窊	pwex
窦	pwfs
窴	pwfw
窷	pwhc
窫	pwhs
窏	pwig
窪	pwij
窙	pwjc
窐	pwjj
空	pwjl
竇	pwjm
竈	pwjp
窥	pwjq
穽	pwjr
窍	pwjx
穻	pwkg
竀	pwkq
窉	pwkw
窀	pwkx
窧	pwlf
窅	pwm
窩	pwmb
帘	pwml
窋	pwmm
窠	pwnd
窤	pwnx
窕	pwoq
窌	pwqc
逾	pwqn
窞	pwqr
究	pwqt
窇	pwqv
窎	pwqx
窵	pwqx
鴪	pwqx
穸	pwqy
竆	pwrb
窱	pwrd
窻	pwrp
邈	pwrq
窗	pwrt
窮	pwrv
竄	pwrx
竂	pwsi
鶟	pwsq
竉	pwst
突	pwsu
途	pwt
窖	pwtj
窄	pwtl
遥	pwtm
窑	pwtm
窆	pwtp
穾	pwts
竁	pwtt
窲	pwuf
窯	pwuo
窭	pwux
窘	pwvb
窟	pwvm
窡	pwvv
穹	pwvx
容	pwwb
彮	pwwe
窬	pwwn
窸	pwwp
窰	pwwt
竊	pwwx
窹	pwxb
窈	pwxc
梥	pwxd
窼	pwxd
窓	pwxp
窽	pwxq
窣	pwyf
窨	pwyn
窔	pwyw
迨	pxb
邋	pxbx
鄳	pxc
巡	pxg
黽	pxii
安	pxk
遦	pxmw
逘	pxts
逡	pxwt
遪	pxxe
這	py
祴	pyaf
祬	pyaj
祵	pybd
祻	pybf
禪	pybf
邅	pybk
祌	pybl
祝	pybq
祦	pybs
祸	pybw
祁	pyc
祠	pycb
祤	pycc
祂	pycl
礽	pycp
禫	pydf
禣	pydg
禋	pydj
祈	pyek
禠	pyem
祜	pyfb
禖	pyfd
遧	pyfg
祺	pyfh
禥	pyfj
禃	pyfm
遮	pyfo
禛	pyfw
这	pyg
迬	pyh
祷	pyhg
禊	pyhs
礻	pyii
社	pyj
禧	pyjb
祎	pyjc
禱	pyjg
祙	pyji
禇	pyjn
祾	pyjt
祛	pyjx
福	pykn
祆	pyks
禰	pykw
祉	pyll
祯	pylm
禂	pymb
禍	pymb
禤	pymc
適	pymf
迒	pymg
祖	pymh
视	pymq
禯	pyms
禮	pymu
祋	pymv
禢	pync
祼	pynd
禓	pyne
神	pynl
禗	pynp
禵	pyns
禝	pynt
禩	pynw
禑	pyny
祧	pyoq
禈	pypa
遆	pypm
禭	pyps
祕	pypt
祇	pyqa
祪	pyqc
祢	pyqi
祹	pyqt
祗	pyqy
禆	pyrf
祔	pyrg
祏	pys
祐	pysb
遃	pyse
祳	pysj
祓	pysy
遊	pytc
祩	pyti
祍	pytj
祰	pytj
祚	pytl
禶	pytm
祣	pytq
祅	pyts
祑	pytw
禉	pyud
禅	pyuf
祥	pyuh
禚	pyuo
祱	pyuq
禙	pyuq
禷	pyus
祶	pyut
禌	pyux
祃	pyv
禡	pyv
禄	pyvh
祀	pyvp
禕	pyvt
祲	pyvv
祫	pywb
禴	pywf
禬	pywn
迹	pywr
禐	pywv
礼	pyx
祿	pyxi
逳	pyxq
禒	pyxs
禨	pyxw
禞	pyyb
禟	pyyb
祊	pyyc
祽	pyyf
禘	pyym
禳	pyyq
月	q
膒	qabb
氒	qafg
氏	qag
胨	qaiw
胵	qaj
腻	qajm
帋	qaml
昏	qan
脦	qapu
臔	qavm
氐	qay
邸	qayc
鸱	qayq
句	qb
膕	qbak
臊	qbbd
腭	qbbx
邭	qbc
劬	qbct
斪	qbek
胭	qbg
脭	qbh
腘	qbhy
脵	qbks
肿	qbl
膭	qblm
脶	qbmw
够	qbqq
欨	qbqw
鸲	qbqx
雊	qbrl
敂	qbtw
胑	qbw
膃	qbwm
卬	qc
脇	qccc
肠	qce
肊	qcg
斵	qcke
肔	qcl
鄮	qcmc
贸	qcmw
留	qcnb
鶹	qcnq
鹠	qcnq
肋	qct
脡	qctj
脠	qctl
腱	qcvl
鵩	qcvq
服	qcvy
膠	qcwe
劉	qcwn
肕	qcy
臎	qcyf
膊	qdgy
膘	qdji
臛	qdrl
臑	qdsm
脯	qdu
匍	qdu
膤	qdvh
膝	qdwi
腰	qdxk
勿	qe
肜	qe
腯	qefm
胻	qeg
肵	qek
甮	qemj
曶	qen
刎	qeng
忽	qepu
脈	qeq
胍	qex
匆	qey
怱	qeyp
臓	qfaa
臟	qfaa
腜	qfd
膹	qffm
肝	qfl
朠	qfms
腊	qfn
膜	qfns
臈	qfnw
脖	qfpc
朦	qfps
臒	qfrv
腩	qfu
臙	qfuo
肢	qfvy
匒	qfwb
朑	qfx
膵	qfyf
儿	qg
脙	qgoy
胤	qgxq
肘	qgy
胀	qha
脹	qha
腠	qhks
肨	qhl
腈	qhq
脿	qhq
膆	qhx
尔	qi
玺	qihy
勹	qiii
膛	qij
覙	qimq
胱	qisx
乐	qiw
脳	qiwx
肚	qj
膨	qjbe
臌	qjbv
勻	qjg
胿	qjj
膮	qjjs
肛	qjl
朊	qjqg
肼	qjr
	qjv
肤	qjwg
肟	qjx
脚	qjxc
胠	qjxy
鱼	qk
鳡	qkap
胢	qkb
鲴	qkbf
脨	qkbi
匐	qkbn
膈	qkbu
鳄	qkbx
印	qkc
鲺	qkcl
鱽	qkco
鳛	qkcr
鳔	qkdj
鳕	qkdv
鲘	qkeb
鳓	qkfc
鲽	qkfd
鲯	qkfh
鲼	qkfm
鳠	qkfv
	qkhn
鲭	qkhq
鲰	qkhv
鲿	qkix
鲒	qkjb
鲑	qkjj
鳍	qkjn
鲮	qkjt
鲓	qkjx
鲄	qkkb
鲾	qkkn
鲆	qkku
鲠	qkkw
鲀	qkkx
鲡	qkky
鲇	qklb
鲈	qklv
鲷	qkmb
鳏	qkmi
肺	qkml
鲗	qkmn
鳢	qkmu
脼	qkmy
鲁	qkn
鳎	qknc
鲱	qknf
鲥	qkng
腖	qkni
鲤	qknj
鲣	qknj
鳀	qknl
鳁	qknm
鲳	qknn
鲉	qkno
鳃	qknp
鳂	qknq
鳗	qknv
鲲	qknx
鲢	qkpa
鳊	qkpf
鲩	qkpq
	qkqc
鲍	qkqv
鲋	qkrg
鳇	qkrh
鳈	qkri
鲌	qkrn
鲵	qkrq
鲕	qksm
鲔	qksq
鳜	qksq
鱿	qksx
鲅	qksy
稣	qktd
鲦	qktd
鲊	qktl
鳅	qkto
鳆	qktt
鳤	qktv
鲧	qktx
鳝	qkub
	qkud
鳟	qkug
鲜	qkuh
匉	qkuk
胓	qkuk
鳞	qkut
鳒	qkuw
鲪	qkvb
鲫	qkvc
鲟	qkvg
鱾	qkvk
鳋	qkvl
鲬	qkvm
鲃	qkvn
鲏	qkvv
胰	qkvw
鲶	qkwp
鳐	qkwt
鲙	qkwx
鲐	qkxb
鲹	qkxe
脛	qkxj
鲻	qkxn
肫	qkxx
鲂	qkyc
鲸	qkyi
鳣	qkyk
鳙	qkyl
鲚	qkyr
鲛	qkyw
鳑	qkyy
胋	qlb
胩	qlkl
臚	qlnm
臄	qlse
胪	qlvd
胪	qlvt
角	qm
觶	qmbf
蟹	qmcl
解	qmct
觙	qmcy
觚	qmex
觾	qmfo
膿	qmfs
腆	qmfw
肌	qmg
觩	qmgy
觥	qmis
觘	qmit
鲷	qmjb
觨	qmji
觟	qmjj
觰	qmjn
胴	qmkb
觫	qmki
触	qml
朏	qmm
胐	qmm
觿	qmmb
觽	qmmc
觸	qmml
臞	qmmr
觛	qmnk
觗	qmqa
觤	qmqc
臅	qmql
觼	qmqt
鵤	qmqx
觝	qmqy
觹	qmrc
膗	qmrl
觬	qmrq
觭	qmsb
腨	qmsm
胦	qmsy
觡	qmtb
觞	qmte
斛	qmuf
觯	qmuf
觧	qmuh
觲	qmut
股	qmv
腡	qmvb
觮	qmvh
觖	qmvw
肭	qmwg
朒	qmww
觻	qmxd
觓	qmxl
觪	qmyf
旬	qn
甸	qnb
郇	qnc
腂	qnd
腓	qnf
刖	qng
胆	qnk
腸	qnke
腲	qnkq
腗	qnkr
胂	qnl
腽	qnmn
腢	qnmy
胛	qnp
腮	qnpu
腥	qnth
銞	qnw
乌	qo
魚	qo
鰔	qoab
鰸	qoab
鯎	qoac
鰹	qoaj
鱤	qoap
鮔	qoav
鰄	qoax
鰋	qoax
鮰	qobb
鱢	qobd
鯝	qobf
鱓	qobf
鰮	qobm
鮂	qobw
鰐	qobx
邬	qoc
鄔	qoc
鮉	qocb
鮙	qocc
鯅	qocl
鯴	qocl
鯭	qocm
魛	qoco
鰼	qocr
鰎	qocv
魥	qocy
鱏	qodf
鱄	qodg
鰾	qodj
鯂	qodk
鱩	qodn
鱬	qods
鯆	qodu
鱈	qodv
鯠	qodw
鮜	qoeb
魬	qoev
鮕	qofb
鰙	qofb
鰳	qofc
鰈	qofd
鯕	qofh
魽	qofj
鱝	qofm
鰗	qofq
鱹	qofr
鱯	qofv
鱑	qofw
鱴	qofy
鯄	qogy
鱷	qohb
鰿	qohm
鰆	qohn
鯖	qohq
鯫	qohv
鮿	qohx
烏	qoii
鱨	qoin
鮹	qoiq
魦	qoit
鯋	qoit
鮚	qojb
鱚	qojb
鮇	qoji
鮭	qojj
鯥	qojj
魟	qojl
鰪	qojm
鯺	qojn
鰭	qojn
魭	qojq
鱙	qojs
鯪	qojt
鯐	qojw
魼	qojx
鮱	qojx
鮳	qojx
魺	qokb
鯃	qokb
鯟	qoki
鰊	qoki
魱	qokk
魳	qokm
鯻	qokn
鰏	qokn
鰽	qokn
鮃	qoku
鮧	qokw
鯁	qokw
魨	qokx
鱺	qoky
鮎	qolb
鮛	qoli
鯱	qolm
鱸	qolm
鱋	qoln
鱥	qolt
鰬	qoly
鮦	qomb
鯛	qomb
鰥	qomi
鱰	qomj
鰂	qomn
鱞	qomq
鱡	qoms
鱧	qomu
魶	qomw
魯	qon
鰨	qonc
鯣	qone
鰑	qone
鯡	qonf
魝	qong
鰣	qong
鯉	qonj
鱪	qonj
鯷	qonl
鰛	qonm
鯧	qonn
鮋	qono
魻	qonp
鰓	qonp
鰃	qonq
鯹	qont
鰻	qonv
鯤	qonx
鰅	qony
朥	qooc
鮡	qooq
腅	qoow
鯶	qopa
鰘	qopa
鰱	qopa
鰫	qopb
鯿	qopf
鯮	qopj
鰚	qopk
鰰	qopl
魫	qopq
鯇	qopq
鱁	qops
鮅	qopt
魲	qopv
鮀	qopx
鮟	qopx
鱦	qopx
鮈	qoqb
鮠	qoqc
鮣	qoqc
魩	qoqe
朓	qoqg
脁	qoqg
鰶	qoqj
鰡	qoqn
鱻	qoqo
鰞	qoqo
鮸	qoqq
鱌	qoqs
鮑	qoqv
歍	qoqw
鷠	qoqx
魡	qoqy
鮘	qora
鮴	qord
鰷	qord
鮒	qorg
鯓	qorh
鰉	qorh
鰁	qori
鮊	qorn
鯢	qorq
鮲	qors
鯸	qort
魸	qorv
鯾	qorw
鱮	qorw
魤	qorx
鮖	qos
魾	qosk
鮞	qosm
鮪	qosq
鰖	qosq
鱖	qosq
魷	qosx
鮬	qosx
鮁	qosy
鱱	qosy
魠	qota
魹	qota
鮥	qotb
鯦	qotb
鱎	qotb
鱵	qotb
鯚	qotc
穌	qotd
鮏	qoth
鮢	qoti
鯌	qotj
鮓	qotl
鰤	qotm
鯏	qotn
鯯	qotn
鰍	qoto
鰒	qott
鮗	qotu
鯀	qotx
鯘	qotx
魞	qoty
鱔	qoub
鰌	qoud
鮩	qouf
鱒	qoug
鮮	qouh
鱛	qoun
鮵	qouq
鮷	qout
鱗	qout
鱃	qouv
鰜	qouw
鰦	qoux
鱶	qouy
鰢	qov
鮶	qovb
鱊	qovb
魣	qovc
鯽	qovc
鰇	qovd
鱘	qovg
魢	qovk
鰠	qovl
鯒	qovm
鯞	qovm
鱍	qovm
鮄	qovr
鱐	qovr
鰯	qovu
鮍	qovv
鮼	qovv
鰕	qovv
灳	qow
魚	qow
鮯	qowb
魵	qowc
鯩	qowf
魜	qowg
鯑	qowm
鱕	qown
鱠	qown
魿	qowp
鯰	qowp
膌	qowq
魪	qowr
鮽	qowt
鯼	qowt
鰩	qowt
鱫	qowt
鰀	qowv
鮾	qowx
鮐	qoxb
鱜	qoxc
鱳	qoxd
鯵	qoxe
鰺	qoxe
鱂	qoxg
鮨	qoxn
鯔	qoxn
鮻	qoxt
魮	qoxx
鱲	qoxx
鰝	qoyb
魴	qoyc
鯙	qoyc
鱆	qoyf
魰	qoyg
鯨	qoyi
鱇	qoyi
鱣	qoyk
鱅	qoyl
魧	qoym
鯍	qoyr
鱭	qoyr
鯲	qoyu
鮫	qoyw
鮌	qoyx
鯜	qoyx
鯳	qoyy
鰟	qoyy
腪	qpaf
膣	qpaj
膑	qpew
臗	qpfy
腚	qpg
腙	qpji
腔	qpjl
脘	qpjq
臏	qpkm
膼	qpmb
脓	qpq
腕	qpqc
膸	qpsq
膖	qpth
膇	qptv
腿	qpvq
胺	qpxk
朋	qq
胝	qqay
朐	qqb
胊	qqb
脕	qqbq
肳	qqe
脗	qqeb
朤	qqqq
鹏	qqqx
脆	qqsc
膽	qqsy
勼	qqt
肍	qqt
胞	qqv
脃	qqvn
肷	qqw
胸	qqwx
匇	qqy
肑	qqy
肒	qqy
褜	qqyq
匔	qrbb
脾	qrfg
胕	qrgy
腶	qrhm
腺	qrio
脽	qrl
臇	qrlc
胉	qrn
膲	qrow
腉	qrqg
兜	qrvq
匑	qrvx
膄	qrvy
腴	qrwg
膍	qrwx
脴	qsb
腼	qsbj
豚	qse
脤	qsj
胯	qsjx
胚	qsk
肧	qsl
胹	qsm
脜	qsm
腌	qsnx
脄	qsow
腝	qssy
胧	qst
朧	qst
肰	qsu
膫	qsui
胈	qsvy
脥	qsww
肬	qsx
肱	qsxy
肽	qsy
九	qt
胳	qtb
叴	qtb
卯	qtc
乮	qtcc
肐	qtcg
胣	qtcl
杂	qtd
雑	qtdr
卆	qtfg
腄	qtfk
膴	qtfo
胜	qth
腁	qtkf
腫	qtkj
臐	qtko
胙	qtlg
虓	qtlm
匋	qtm
旭	qtn
旮	qtn
膓	qtne
脷	qtng
腹	qtnt
臜	qtqm
臢	qtqm
鸠	qtqx
頄	qtsw
胮	qttj
脌	qttj
膬	qttt
馗	qtur
卿	qtvc
胅	qtwg
腇	qtxk
胏	qtxt
脢	qtxu
厹	qtxy
丸	qty
訄	qty
奿	qtyx
匀	qu
腃	quc
孵	qucc
毈	qucm
贕	qucm
勝	quct
卵	qucy
脒	qud
匊	qud
榺	qud
胼	quf
羘	quh
膶	quh
滕	quio
胖	quj
塍	quj
螣	qul
膡	qum
幐	quml
黱	qumo
賸	qumw
脱	quq
	quqk
鰧	quqo
膦	quqt
鵴	quqx
朕	qusy
膳	quub
腾	quv
騰	quv
膁	quw
膉	quwm
縢	qux
媵	quxk
謄	quy
包	qv
腛	qvaj
勉	qvbc
膙	qvbl
劖	qvbn
免	qvbq
象	qvbs
兔	qvby
腒	qvfb
刍	qvh
	qvii
脲	qvio
胫	qvj
腵	qvjv
膯	qvku
亇	qvl
蜰	qvl
烉	qvmo
奂	qvms
夐	qvmt
敻	qvmt
匓	qvmv
负	qvmw
肥	qvn
刨	qvng
龟	qvnx
炰	qvow
胇	qvr
臽	qvrj
燄	qvro
欿	qvrq
鵮	qvrq
鹐	qvrq
厃	qvs
危	qvsc
頠	qvss
矦	qvst
詹	qvsy
腬	qvtd
邹	qvvc
刍	qvvh
争	qvvl
色	qvvn
煞	qvvo
急	qvvp
雏	qvvr
皱	qvvv
胒	qvx
久	qvy
灸	qvyo
粂	qvyu
麁	qvyx
欠	qw
匌	qwb
脫	qwbq
臉	qwbw
脬	qwck
朌	qwco
肦	qwco
胁	qwct
脎	qwd
胗	qwe
肸	qwfg
勽	qwg
脟	qwgy
脸	qwik
脍	qwjx
肹	qwkx
腀	qwmf
膾	qwmn
膰	qwn
朎	qwp
腧	qwqn
脪	qwsm
腳	qwwc
脞	qwwj
脮	qwxk
匈	qwxl
胷	qwxq
膎	qwxs
朡	qwxt
匁	qwy
腍	qwyp
肣	qwyv
鸟	qx
匂	qx
胎	qxb
臘	qxbx
鄥	qxc
鳦	qxcg
鳨	qxct
枭	qxd
梟	qxd
鄡	qxdc
鷈	qxem
鶀	qxfh
鹱	qxfv
鳥	qxii
肗	qxk
鴚	qxkb
凫	qxmg
岛	qxmx
脂	qxn
鵿	qxnf
鸔	qxni
鴥	qxpw
鸵	qxpx
鄒	qxqc
鶵	qxqq
雛	qxqr
皺	qxqv
芻	qxqx
鴏	qxra
鵻	qxrl
鶃	qxrq
腦	qxrw
腞	qxse
鴼	qxtb
鶳	qxtm
鴤	qxtu
胟	qxu
鸃	qxua
鷌	qxv
鵦	qxvh
鴃	qxvw
匃	qxwg
朘	qxwt
脧	qxwt
鵌	qxwt
肶	qxx
胤	qxxq
鵔	qxxt
勾	qxy
膷	qxyc
袅	qxyq
鷻	qxyt
夕	qy
訇	qy
匄	qya
膱	qyat
名	qyb
朜	qybc
脝	qybc
膻	qybk
肪	qyc
夗	qyc
夘	qyc
邜	qyc
眢	qycm
怨	qycp
鸳	qycq
臍	qycr
駌	qycv
妴	qycx
頯	qyfs
勺	qyii
脉	qyio
脏	qyj
祭	qyji
豋	qyku
外	qylg
夞	qylx
肮	qymg
腤	qyn
朣	qynj
膧	qynj
膟	qyof
爒	qyoi
炙	qyow
膪	qypb
腣	qypm
臆	qypu
夤	qypw
膀	qypy
夡	qyqb
卶	qyqc
翗	qyqc
夠	qyqq
郺	qyqv
多	qyqy
脐	qyr
腑	qyrg
腋	qyry
然	qyso
桀	qytd
夝	qyth
舛	qytj
斘	qyuf
臁	qyuw
朖	qyv
膅	qyvb
脺	qywf
飧	qywv
胶	qyww
脑	qywx
肞	qywy
膔	qyx
臃	qyxr
胲	qyxw
胘	qyxx
詧	qyy
的	r
俴	raat
傴	rabb
柋	rad
伡	raf
俥	raf
侄	raj
垡	raj
垈	raj
侙	rajl
伢	ral
傶	rali
帒	raml
黛	ramo
贷	ramw
岱	ramx
倒	rang
偃	ranx
僭	raqn
侥	rasx
伐	rat
牮	ratl
儖	ratm
僌	ratw
佢	rav
伛	rawy
代	ray
袋	rayq
鬼	rb
魊	rbak
魆	rbax
侣	rbb
佪	rbb
偘	rbbb
僺	rbbd
僤	rbbf
儼	rbbt
偔	rbbx
保	rbd
堡	rbdj
賲	rbdm
煲	rbdo
鬽	rbe
鬿	rbek
囪	rbey
個	rbfb
郫	rbfc
卑	rbfg
魌	rbfh
鹎	rbfq
鬾	rbfv
侱	rbh
偮	rbhd
魈	rbiq
魅	rbji
俣	rbks
魉	rbkw
魎	rbky
仲	rbl
促	rbll
僓	rblm
魖	rbln
傊	rbm
魍	rbmy
魓	rbnj
侃	rbr
侶	rbrb
魋	rbrl
諐	rbry
魃	rbsy
悤	rbtp
囱	rbtw
魁	rbuf
魐	rbuw
粤	rbux
俋	rbvn
伿	rbw
恖	rbwp
魀	rbwr
顖	rbws
粵	rbwx
囟	rbwy
俁	rbxs
魕	rbxw
魑	rbyx
伺	rcb
伽	rcb
佋	rcb
亿	rcg
仔	rck
他	rcl
仍	rcp
怹	rcpu
仂	rct
侹	rctj
健	rcvl
僇	rcwe
仞	rcy
仭	rcy
伋	rcy
休	rd
傈	rdd
僸	rddj
儊	rddv
価	rdg
傅	rdgy
僄	rdji
体	rdk
價	rdmw
烋	rdow
僡	rdpu
恷	rdpu
僲	rdqt
鸺	rdqx
儒	rdsm
僊	rdsv
俌	rdu
僳	rdud
倈	rdww
倯	rdwx
偠	rdxk
儨	reem
偱	refm
俇	reh
偫	rejg
伒	rek
傂	relm
俽	reqw
侜	reu
仮	revy
傱	rewl
傤	rfaf
儎	rfaf
估	rfb
僅	rfbh
儺	rfbr
傼	rfbw
僷	rffd
偾	rffm
什	rfg
倛	rfh
傇	rfhd
佄	rfj
仠	rfl
值	rfmh
傋	rfmj
儚	rfmq
偀	rfms
傎	rfmw
借	rfn
僙	rfnw
侼	rfpc
僃	rfqm
僀	rfqm
儆	rfqt
僛	rfqw
偌	rfsb
備	rftm
憊	rftp
做	rftw
伎	rfvy
供	rfw
儰	rfwo
偡	rfx
伳	rfx
偞	rfxd
俅	rgoy
怤	rgpu
姇	rgxk
付	rgy
身	rh
仼	rh
伥	rha
倀	rha
軀	rhab
躯	rhaw
躽	rhax
躳	rhbb
軃	rhbf
倻	rhc
躱	rhcd
躵	rhcp
偰	rhcs
佴	rhd
躰	rhdk
仨	rhg
射	rhgy
俦	rhgy
躼	rhha
躺	rhib
傣	rhio
軇	rhjg
俸	rhjl
仹	rhl
躲	rhmd
儬	rhmq
軆	rhmu
段	rhmv
债	rhmw
偆	rhn
躶	rhnd
軂	rhoc
躻	rhpj
軉	rhpm
躭	rhpq
倩	rhq
俵	rhq
躹	rhqu
鵢	rhqx
躸	rhsb
軅	rhsr
傲	rhtw
躷	rhtx
躾	rhus
軁	rhux
躬	rhvx
躮	rhwc
傃	rhx
軄	rhya
躿	rhyi
軈	rhyp
躴	rhyv
川	ri
亻	riii
偿	rijx
倘	rimb
儻	rimo
僘	rimt
償	rimw
儅	rinb
傥	rip
俏	riq
侊	risx
仯	rit
偗	ritm
仦	riw
仕	rj
舆	rjaw
佶	rjb
儓	rjba
僖	rjbb
伟	rjc
侾	rjck
舁	rjf
仁	rjg
侍	rjgy
臼	rjii
盥	rjim
佅	rjiw
佳	rjj
毁	rjjm
僥	rjjs
轝	rjka
舉	rjkj
舃	rjko
歟	rjkq
鸒	rjkq
礜	rjks
擧	rjkt
與	rjkw
侤	rjkx
譽	rjky
仜	rjl
釁	rjmc
帠	rjml
儥	rjmm
舋	rjmm
爨	rjmo
臖	rjmq
興	rjmw
璺	rjmy
偖	rjn
舅	rjnc
俧	rjpu
郳	rjqc
兒	rjqg
舄	rjqo
鶂	rjqq
夓	rjst
倖	rjuj
毇	rjum
传	rjv
鄋	rjvc
儔	rjvg
叟	rjvy
學	rjwc
斞	rjwf
臾	rjwg
澩	rjwi
壆	rjwj
儧	rjwm
嶨	rjwm
僣	rjwn
燢	rjwo
鱟	rjwo
惥	rjwp
覺	rjwq
觷	rjwq
鷽	rjwq
雤	rjwr
礐	rjws
倰	rjwt
斆	rjwt
嚳	rjwt
斅	rjwv
黌	rjww
佬	rjx
鼲	rjxa
鼯	rjxb
鼢	rjxc
鼠	rjxg
鼱	rjxh
佞	rjxk
鼰	rjxm
鼶	rjxm
鼬	rjxn
鼩	rjxq
鼷	rjxs
鼪	rjxt
鼮	rjxt
鼨	rjxu
鼸	rjxu
鼹	rjxx
伝	rjxy
佉	rjxy
鼤	rjxy
鼥	rjxy
倵	rkal
何	rkb
倳	rkbl
偪	rkbn
儾	rkbq
侸	rkbu
使	rkbw
侀	rkfn
仃	rkl
佂	rkll
傿	rklo
侢	rkmj
伂	rkml
傮	rkmn
俩	rkmw
俪	rkmy
例	rkng
倲	rkni
僵	rknk
僫	rknp
俨	rknt
俹	rknu
便	rknw
俫	rkud
伻	rkuk
侠	rkus
伍	rkv
俉	rkvb
倢	rkvl
侇	rkvw
儞	rkww
仗	rkwy
俓	rkxj
仾	rkxk
伅	rkxx
佤	rkxy
候	rl
售	rlb
佔	rlb
隽	rlcp
集	rld
隼	rlfg
鶽	rlfq
仆	rlg
隹	rlii
仩	rlk
佧	rlkl
俶	rlkv
雋	rllc
俿	rlmg
侦	rlmw
倬	rlnf
儢	rlnp
劁	rlon
鹪	rloq
顦	rlos
焦	rlow
燞	rlqo
儏	rlqu
雧	rlrd
雔	rlrl
雥	rlrr
雦	rlrr
犨	rlrt
雙	rlrv
讐	rlry
顀	rlsw
翛	rltc
條	rltd
修	rlte
鞗	rltf
跾	rltl
儵	rltm
偹	rltn
倐	rlto
焂	rlto
鯈	rlto
悠	rltp
脩	rltq
倏	rlts
攸	rltw
絛	rltx
偼	rlvl
候	rlvt
隻	rlvy
佌	rlx
偨	rlxd
雠	rlyr
犫	rlyt
自	rm
向	rmb
郋	rmc
臬	rmd
臲	rmdc
鷍	rmdq
甈	rmdy
儂	rmfs
僼	rmfu
倎	rmfw
仉	rmg
伹	rmh
佣	rmj
倜	rmjb
侗	rmkb
佩	rmkm
儇	rmkq
倶	rmkw
臰	rmkx
伵	rmn
儩	rmne
鼾	rmnf
侧	rmng
齂	rmni
齄	rmnk
齇	rmnm
劓	rmnn
鼽	rmnq
鼻	rmnr
鼿	rmns
齅	rmns
齈	rmns
齆	rmnv
齃	rmnw
鼼	rmnx
齀	rmny
翺	rmoc
臯	rmof
鷱	rmoq
傦	rmp
鄎	rmpc
息	rmpu
臱	rmpy
伣	rmqg
俔	rmqg
傰	rmqq
儶	rmrb
催	rmrl
臮	rmrw
鄓	rmsc
偳	rmsm
臭	rmsu
佒	rmsy
偑	rmtl
嶴	rmum
奥	rmus
伇	rmv
俱	rmw
奧	rmws
侺	rmwv
仙	rmx
臫	rmx
儸	rmxr
辠	rmyf
白	rn
皂	rnag
佃	rnb
傝	rncc
侽	rnct
劰	rnct
倮	rnd
皬	rndr
皈	rnev
俳	rnf
皁	rnfg
儤	rnfi
皣	rnfj
皇	rnh
皟	rnhm
皘	rnhq
皝	rnhs
皩	rnhs
灥	rnii
泉	rnio
俚	rnj
皢	rnjs
但	rnk
皌	rnkd
偒	rnke
偍	rnkl
偎	rnkq
俜	rnkx
伸	rnl
敒	rnlt
皉	rnlx
皗	rnmb
帛	rnml
皠	rnmr
皚	rnmu
皑	rnmv
緜	rnmx
偶	rnmy
倡	rnn
畠	rnnb
皔	rnnf
儡	rnnn
儽	rnnx
伷	rno
翶	rnoc
皐	rnof
皖	rnpq
偲	rnpu
皃	rnqg
偈	rnqw
的	rnqy
魄	rnrb
皥	rnrf
皞	rnrf
皡	rnrf
皨	rnrj
皛	rnrr
皦	rnrt
翱	rnsc
皋	rnsf
鷎	rnsq
皒	rnta
皓	rntj
敀	rntw
皏	rnuf
僕	rnuh
皅	rnvn
皭	rnwg
皤	rnwn
皊	rnwp
皧	rnwt
傫	rnx
癿	rnx
皀	rnx
卽	rnxc
皍	rnxc
皪	rnxd
墍	rnxj
曁	rnxk
儑	rnxo
旣	rnxq
倱	rnxx
皜	rnyb
皫	rnyo
鸄	rnyq
敫	rnyt
皎	rnyw
譥	rnyy
僗	rooc
儝	rood
倓	roow
佻	roqg
伙	row
僆	rpaf
儙	rpbv
傓	rpcc
俕	rpd
傧	rpew
僿	rpfj
倧	rpji
倥	rpjl
俒	rpjq
伫	rpk
佇	rpkl
儐	rpkm
偏	rpmf
伔	rpmg
儜	rppk
侬	rpq
倇	rpqc
傕	rprl
僱	rprl
傢	rpse
佖	rpt
侘	rpta
伈	rpu
倌	rpv
僒	rpvb
傛	rpwb
佗	rpx
僶	rpx
侒	rpxk
仴	rq
低	rqay
佝	rqb
佲	rqb
俛	rqbq
像	rqbs
儳	rqby
仰	rqc
伆	rqe
偬	rqep
伜	rqfg
你	rqi
傺	rqji
偩	rqmw
侚	rqn
您	rqpu
倗	rqq
侈	rqqy
佹	rqsc
儋	rqsy
仇	rqt
傑	rqtd
伨	rqu
佨	rqv
	rqvh
俷	rqvn
	rqxx
仢	rqy
傀	rrb
俾	rrfg
偟	rrh
倠	rrl
儁	rrlc
伯	rrn
僬	rrow
倪	rrqg
傯	rrtp
傁	rrvy
傻	rrwt
儌	rryt
佦	rs
佑	rsb
俖	rsb
偭	rsbj
伌	rsc
倴	rsff
傉	rsgy
侲	rsj
倷	rsji
佐	rsjl
侉	rsjx
伾	rsk
倚	rskb
伓	rsl
侟	rslc
侕	rsm
佈	rsml
優	rsmt
佰	rsn
俺	rsnx
侑	rsq
偧	rsqq
傆	rsri
偄	rssy
儱	rst
儮	rstl
伏	rsu
僚	rsui
傄	rsum
伖	rsvy
顺	rsw
順	rsw
俠	rsww
傸	rsww
优	rsx
仛	rtag
俄	rtat
佫	rtb
俰	rtb
倁	rtb
偊	rtby
仡	rtcg
伤	rtct
栠	rtd
俢	rte
仟	rtfg
倕	rtfk
偛	rtfr
儛	rtft
侏	rtiw
任	rtj
俈	rtj
仵	rtk
働	rtkc
倂	rtkf
偅	rtkj
件	rtl
倃	rtlb
作	rtlg
偺	rtln
佸	rtm
凭	rtmg
侐	rtmn
赁	rtmw
俻	rtnb
傷	rtne
俐	rtng
僽	rtop
偢	rtow
恁	rtpu
侁	rtqg
儹	rtqm
鵀	rtqx
僑	rtsb
侨	rtsr
仸	rtsy
佭	rttj
佟	rtu
佚	rtwg
係	rtx
倭	rtxk
侮	rtxu
仫	rtxy
偸	rtyx
倦	ruc
伪	rucy
侎	rud
僔	rudg
偤	rudk
併	ruf
佯	ruh
伴	ruj
傞	rujl
僧	rumn
僴	run
们	rup
們	rup
侻	ruq
偝	ruq
僩	ruq
偂	ruqn
僯	ruqt
佽	ruqw
儀	ruta
僐	ruub
儯	ruv
偽	ruvo
俤	ruvt
傔	ruw
偻	ruxk
片	rv
佀	rv
傌	rv
牋	rvaa
偓	rvaj
偉	rvbt
僻	rvby
伃	rvc
侷	rvcb
牊	rvcb
僝	rvcc
牔	rvdg
版	rvev
倨	rvfb
牒	rvfd
牍	rvfs
牘	rvjm
假	rvjv
僜	rvku
伄	rvl
侓	rvl
儘	rvlm
俑	rvmj
倔	rvmm
覑	rvmq
牖	rvpd
牑	rvpf
侵	rvpv
佷	rvq
偦	rvq
牎	rvqp
佛	rvr
牌	rvrf
傩	rvrl
牕	rvrp
伊	rvt
侰	rvtb
僪	rvtb
鄇	rvtc
牐	rvtr
侯	rvts
偋	rvuf
牉	rvuj
佊	rvv
僎	rvvw
牏	rvwn
伲	rvx
仅	rvy
伬	rvy
牗	rvyl
侭	rvyu
牓	rvyy
仈	rw
佮	rwb
倹	rwbw
儉	rwbw
伧	rwc
俘	rwck
份	rwco
倸	rwd
佺	rwh
俭	rwik
伱	rwiw
侩	rwjx
倫	rwmf
偁	rwmj
儈	rwmn
佡	rwmx
僠	rwn
儍	rwot
伶	rwp
僢	rwpt
僾	rwpt
僁	rwpu
佾	rwq
偷	rwqn
价	rwr
俙	rwsm
倄	rwsq
俆	rwt
倽	rwtm
傜	rwtm
僞	rwto
俗	rwwb
侳	rwwj
伦	rwx
傟	rwxc
俀	rwxk
倊	rwxp
傒	rwxs
伀	rwxy
傖	rwyb
僋	rwym
仱	rwyv
化	rx
佁	rxb
侞	rxb
儠	rxbx
华	rxfg
値	rxfm
货	rxmw
倾	rxsw
侔	rxtl
俟	rxts
儗	rxtv
伮	rxvy
俊	rxwt
仳	rxx
傪	rxxe
偕	rxxr
僟	rxxw
仏	rxy
似	rxyw
信	ry
倍	ryb
傐	rybb
倞	rybi
停	rybk
偯	rybq
儴	rybq
僦	rybs
仿	ryc
儕	rycr
儭	rydq
傽	ryfg
儣	ryfw
伩	ryg
傠	rygy
住	ryh
储	ryjn
伉	rymg
偣	ryn
僮	rynj
儦	ryow
偙	rypm
億	rypu
傍	rypy
依	ryq
傹	ryqg
侪	ryr
俯	ryrg
偐	ryse
侂	ryta
倣	rytw
位	ryu
俍	ryv
傏	ryvb
傭	ryvl
俲	rywc
倅	rywf
傚	rywt
佼	ryww
仪	rywy
侫	ryxk
倿	ryxk
傗	ryxn
俼	ryxq
侅	ryxw
伭	ryxx
傡	ryyu
在	s
碊	saat
砌	saco
厍	saf
砗	saf
厙	saf
硨	saf
厔	saj
碱	sakb
砑	sal
厊	sal
磩	sali
砸	saml
硗	sasx
礛	satm
礥	savm
右	sb
硘	sbb
靣	sbb
磾	sbbf
礹	sbbt
硱	sbd
厛	sbek
磒	sbm
勔	sbnc
面	sbnj
蠠	sbnl
靧	sbnm
靤	sbnq
靦	sbnq
碅	sbtd
厑	sbx
厄	sc
砀	sce
乭	scg
矷	sck
磖	scrn
顾	scsw
历	sct
劯	sct
硟	sctl
磟	scwe
砐	scy
碄	sdd
歴	sddl
礵	sddm
暦	sddn
厯	sddu
礎	sddv
硒	sdg
磗	sdgy
磚	sdgy
磦	sdji
砵	sdk
厢	sdm
礌	sdnb
磹	sdnf
碴	sdnk
礭	sdrl
礝	sdsm
硹	sdwx
豧	sedu
豵	seel
礩	seem
碷	sefm
豮	sefm
豶	sefm
豕	seii
櫫	sejd
豬	sejn
豷	seju
斫	sek
豜	sekf
豣	sekf
豘	sekx
蟸	sell
磃	selm
豠	semh
豛	semv
剢	seng
豱	senm
豟	sepc
豞	seqb
豩	sese
豲	sesi
豳	sesm
燹	seso
甤	seth
磤	sevm
豝	sevn
豤	sevq
豭	sevv
磫	sewl
豨	sewm
豯	sews
豴	seyf
豥	seyw
礷	sfam
厪	sfbh
礶	sfbr
礡	sfdg
厮	sfek
礴	sfig
礚	sfjm
矸	sfl
厈	sfl
碤	sfms
厧	sfmw
磌	sfmw
礣	sfmy
厝	sfn
碏	sfn
勵	sfnc
磺	sfnw
厲	sfny
礞	sfps
礤	sfqj
硴	sfrx
硔	sfw
砹	sfwy
碪	sfx
磡	sfxc
碟	sfxd
硭	sfya
碶	shcs
硦	shf
碛	shmw
碃	shq
厫	shtw
磝	shtw
碡	shxu
砡	shy
石	si
磲	siad
厂	siii
厰	simt
礑	sinb
泵	sio
砅	sio
硝	siq
硄	sisx
砂	sit
礃	sitg
辰	sj
圧	sj
唇	sjb
硈	sjb
礂	sjbb
硣	sjck
鄏	sjgc
辱	sjgy
硅	sjj
厓	sjj
磽	sjjs
左	sjl
蜃	sjl
矼	sjl
蜃	sjli
碽	sjmw
脣	sjq
毻	sjqt
敐	sjtw
砖	sjv
砆	sjwg
硳	sjwr
碐	sjwt
硓	sjx
磕	sjxm
砝	sjxy
压	sjy
碔	skal
砢	skb
厨	skbg
励	skcc
厉	skct
砞	skd
研	skf
硎	skfn
揅	skft
厅	skl
矴	skl
礓	sknk
硬	sknw
硏	sksf
砰	skuk
硖	skus
硜	skxj
砘	skxx
砙	skxy
不	sl
否	slb
砧	slb
磠	slbo
硵	slbw
存	slck
嫑	sldx
在	slj
丕	slk
邳	slkc
歪	slkl
砋	sll
甭	slmj
盃	slmn
覔	slmq
碵	slmw
鴀	slqx
奀	slsy
孬	slxc
而	sm
冇	sm
戛	smat
耏	sme
碘	smfw
矶	smg
耐	smgy
砠	smh
砽	smj
碉	smjb
礋	smju
硐	smkb
磑	smku
布	sml
础	smm
厕	smng
磆	smp
戞	smpa
鄾	smpc
憂	smpt
恧	smpu
砚	smqg
磞	smqq
鸸	smqx
磪	smrl
硸	smsf
碳	smso
奡	smsr
耎	smsy
碸	smtl
夏	smtw
碙	smum
砓	smv
碢	smvb
硙	smvk
磮	smwf
硶	smwv
砜	smwy
耍	smxk
矾	smy
砃	smy
百	sn
厚	snck
厞	snf
矵	sng
厘	snj
碭	snke
碍	snkg
碮	snkl
碨	snkq
砷	snl
礧	snnn
檿	snqd
壓	snqj
靨	snqj
黶	snqm
厴	snqn
懕	snqp
魘	snqr
厭	snqs
擪	snqt
碣	snqw
嬮	snqx
皕	snsn
厬	sntb
礏	snuh
磥	snx
礘	snxo
盔	somn
磱	sooc
礯	soox
灰	sow
砨	spcg
碇	spg
磍	sphb
碂	spji
硿	spjl
碹	spkk
礗	spkm
碥	spmf
碗	spqc
確	sprl
硡	spsx
碦	sptb
磓	sptv
礈	spus
磀	spux
砣	spx
有	sq
戫	sqak
碈	sqan
砥	sqay
郁	sqc
磂	sqcn
砕	sqfg
砾	sqiw
磜	sqji
确	sqm
硼	sqq
硊	sqsc
龓	sqst
磔	sqtd
砲	sqv
碀	sqvl
砍	sqw
鳫	sqx
矽	sqy
磈	srb
磼	srd
碑	srfg
碫	srhm
厵	srii
厡	srio
愿	srip
願	sris
原	sriw
礖	srkw
碓	srl
砶	srn
礁	srow
贗	srqm
磶	srqo
鴈	srqx
雁	srrl
赝	srrm
礇	srus
磇	srwx
硇	srwy
礉	sryt
砳	ss
砈	ssc
厖	sse
硥	sse
硺	sse
礪	ssfy
碕	sskb
砺	sskc
黡	ssmo
厦	ssmt
厣	ssnp
硽	ssnx
磭	ssq
魇	ssrb
磊	sss
靥	sssj
碝	sssy
厐	sst
礲	sst
龎	sst
礰	sstl
厌	ssu
硕	ssw
碩	ssw
餍	sswv
硤	ssww
磢	ssww
矹	ssx
龙	st
厇	stag
矺	stag
硪	stat
硌	stb
矻	stcg
砤	stcl
龏	stf
厜	stfk
硾	stfk
龚	stfw
聋	sthd
龍	stii
硃	stiw
垄	stj
壟	stj
硞	stj
龒	stji
龑	stks
	stks
蠪	stl
砟	stlg
厒	stm
砭	stp
礸	stqm
鸗	stqx
砻	sts
礱	sts
礄	stsb
硚	stsr
龘	stss
龖	stst
厤	sttd
歷	sttl
曆	sttn
磿	stts
驡	stv
詟	sty
讋	sty
袭	styq
犬	su
磸	suds
硑	suf
磋	sujl
磳	sumn
磵	sun
碰	sunu
礀	suq
磷	suqt
飆	susl
猋	suss
飙	susw
礒	suta
磰	suub
磏	suw
橜	suxd
蟨	suxl
蹷	suxl
劂	suxn
憠	suxp
礠	suxp
厥	suxq
磁	suxx
礢	suyv
码	sv
碼	sv
厩	svaq
唘	svb
礔	svby
碾	svfq
碌	svh
碿	sviq
硁	svj
碬	svjv
磴	svku
硉	svl
硧	svmj
硍	svq
砩	svr
破	svv
磉	svvd
砄	svwg
礟	svww
友	svy
犮	svy
盋	svym
礮	svyw
页	sw
碒	sw
硆	swb
厱	swbw
礆	swbw
砏	swco
仄	swg
硂	swh
頁	swii
硷	swik
砼	swjl
碖	swmf
磻	swn
砱	swp
砎	swr
顨	swsr
硢	swt
磘	swtm
硲	swwb
磎	swxs
砛	swyv
尤	sx
尶	sxam
尷	sxam
尵	sxbm
翃	sxcc
尮	sxcd
尨	sxe
尪	sxh
尫	sxh
兀	sxii
尢	sxii
兀	sxii
虺	sxl
尳	sxmp
尴	sxnm
卼	sxqc
尯	sxqc
尥	sxqy
雄	sxrl
碯	sxrw
碜	sxse
尰	sxtj
礙	sxtv
砪	sxu
尲	sxuw
尬	sxwr
砒	sxx
礫	sxxd
磣	sxxe
磯	sxxw
厷	sxy
大	sy
奩	syab
奆	syav
奁	syaw
碚	syb
夻	syb
碻	sybb
碠	sybk
礅	sybt
夯	syct
礳	syds
厗	syf
奔	syff
夲	syfg
礦	syfw
砇	syg
夺	sygy
砫	syh
套	syha
耷	syhd
砯	syio
奫	syir
夵	syiw
圶	syj
郀	syjc
瓠	syje
奲	syjf
夳	syjg
奈	syji
奎	syjj
奢	syjn
刳	syjn
匏	syjq
夸	syjx
奇	sykb
剞	sykn
欹	sykq
攲	sykv
敧	sykv
奯	sylt
奝	symb
砊	symg
奋	synb
剦	synn
鹌	synq
奄	synx
碲	sypm
牵	sypt
磅	sypy
奅	syqc
奓	syqq
奟	syqq
奃	syqy
夼	syr
夰	syr
奪	syrg
奞	syrl
奮	syrn
矿	sys
奤	sysj
奭	sysn
夶	sysy
砬	syu
冭	syu
羍	syuh
尞	syui
眘	syum
昚	syun
鹩	syuq
硠	syv
磄	syvb
夿	syvn
郟	sywc
碎	sywf
磙	sywq
硛	sywr
頰	syws
爽	syww
硫	syxr
硋	syxw
厺	syxy
砿	syxy
太	syy
盇	syym
态	syyp
奒	syyw
我	t
毛	ta
毧	taas
箋	taat
笸	tab
籄	tabm
筬	tac
範	tac
毽	tacv
毢	tadg
毝	tae
氁	tafs
乇	tag
毬	tagy
筐	tah
筺	tahy
毜	taiw
箴	takb
箧	taks
笌	tal
毡	talb
覒	tamq
篚	tanf
箌	tang
筪	tanp
毸	tanp
毯	taoo
簪	taqn
氇	taqn
毥	taqn
氌	taqn
毱	taqu
簐	taqw
篋	tasw
笺	tat
簵	tatb
籃	tatm
毨	tatq
毳	tatt
毩	taud
氆	taun
熈	tavo
毺	tawn
毶	taxe
毪	taxt
毰	tayb
氊	tayk
各	tb
簂	tbak
筥	tbb
簞	tbbf
箇	tbfb
筃	tbg
箿	tbhd
洜	tbio
筽	tbks
篑	tblm
簬	tblt
筼	tbm
篔	tbm
鄅	tbmc
禹	tbmy
鵅	tbqx
兎	tbqy
雒	tbrl
頟	tbsw
箘	tbtd
敋	tbtw
笝	tbvy
气	tc
笳	tcb
笤	tcb
笥	tcb
氤	tcbg
氳	tcbm
氖	tccp
氥	tcdg
箛	tcex
氪	tcfq
氰	tchq
氭	tcki
氫	tckj
氩	tckn
氞	tckw
竾	tcl
氝	tcmw
氙	tcmx
氜	tcn
氱	tcne
刏	tcng
氠	tcnl
氲	tcnm
氮	tcoo
忥	tcpu
氨	tcpx
氚	tcr
氘	tcr
籊	tcrl
氕	tct
竻	tct
筳	tctj
筵	tctl
氡	tctu
氣	tcud
氧	tcuh
氯	tcvh
氢	tcvj
氟	tcvr
氛	tcwc
篨	tcwt
気	tcwy
笈	tcy
氦	tcyw
禾	td
秷	tdaj
稢	tdak
稶	tdak
篐	tdam
秬	tdav
和	tdb
稆	tdbb
稇	tdbd
稒	tdbf
秵	tdbg
程	tdbh
种	tdbl
惒	tdbp
稛	tdbt
积	tdbw
穋	tdce
季	tdck
秀	tdcp
頺	tdcs
篥	tdd
箖	tdd
穗	tddp
穤	tdds
秿	tddu
秫	tddy
穑	tdfb
稘	tdfh
穁	tdfh
簯	tdfh
秆	tdfl
稙	tdfm
稓	tdfn
秓	tdfv
穫	tdfv
稹	tdfw
篿	tdgy
積	tdhm
稧	tdhs
稍	tdiq
秒	tdit
秸	tdjb
秲	tdjg
篻	tdji
稑	tdjj
穘	tdjs
稜	tdjt
秐	tdjx
籈	tdjy
笨	tdk
秣	tdkd
稏	tdkn
稫	tdkn
穂	tdkp
秤	tdku
稉	tdkw
穪	tdkw
穲	tdky
秥	tdlb
穢	tdlt
箱	tdm
稠	tdmb
秃	tdmg
租	tdmh
穨	tdmm
簠	tdmn
盉	tdmn
秽	tdmq
颓	tdms
秧	tdms
穠	tdms
頽	tdms
秈	tdmx
香	tdn
馢	tdna
馠	tdnb
馚	tdnc
馞	tdnc
馟	tdnc
梨	tdnd
稞	tdnd
簟	tdnf
利	tdng
馧	tdnm
馩	tdnm
馪	tdnm
馡	tdnn
馫	tdnn
秞	tdno
悡	tdnp
稩	tdnq
犁	tdnt
馥	tdnt
稷	tdnt
馝	tdnt
穙	tdnu
馦	tdnu
穝	tdnv
穓	tdnw
鋫	tdnw
馤	tdnw
馜	tdnx
馣	tdnx
馛	tdny
醔	tdod
湬	tdoi
蝵	tdol
稥	tdon
愁	tdop
鶖	tdoq
鹙	tdoq
揫	tdot
秋	tdow
媝	tdox
甃	tdoy
秺	tdpa
穃	tdpb
稨	tdpf
穦	tdpm
秾	tdpq
稼	tdps
秘	tdpt
秖	tdqa
剓	tdqc
棃	tdqd
禿	tdqg
称	tdqi
穄	tdqj
黧	tdqm
穞	tdqn
穭	tdqn
籕	tdqn
鯬	tdqo
稳	tdqp
移	tdqq
頹	tdqs
犂	tdqt
黎	tdqw
穐	tdqx
穒	tdqx
秇	tdqy
秪	tdqy
穕	tdrd
穆	tdre
稗	tdrf
稚	tdrl
穛	tdro
籱	tdrr
秹	tdrt
穥	tdrw
秠	tdsk
嵇	tdsm
稽	tdsn
稬	tdss
秡	tdsy
諬	tdsy
秅	tdta
秏	tdta
穚	tdtb
秝	tdtd
秊	tdtf
秊	tdtf
秼	tdti
種	tdtj
秨	tdtl
秳	tdtm
穳	tdtm
龝	tdtp
秗	tdts
秭	tdtt
秩	tdtw
科	tduf
秚	tduj
剩	tdun
税	tduq
稊	tdut
稴	tduw
乘	tdux
稰	tdvq
穊	tdvq
稦	tdvt
穉	tdvt
秛	tdvv
秜	tdvx
稺	tdvy
黏	tdwb
稃	tdwc
稐	tdwf
穱	tdwg
秂	tdwg
黍	tdwi
稀	tdwm
稲	tdwn
稔	tdwp
稅	tdwq
稻	tdwr
稌	tdwt
稯	tdwt
箂	tdww
黐	tdwx
秮	tdxb
穇	tdxe
	tdxe
委	tdxk
覣	tdxq
魏	tdxr
犩	tdxt
稄	tdxt
穖	tdxw
秕	tdxx
私	tdxy
稿	tdyb
稕	tdyc
稡	tdyf
稤	tdyi
穅	tdyi
穜	tdyj
秔	tdym
稸	tdyn
穮	tdyo
穰	tdyq
穧	tdyr
稂	tdyv
穬	tdyw
筕	teg
笊	tei
簁	tell
篪	telm
篽	tetc
籞	tetj
箻	tevl
篵	tewl
笟	tex
升	tf
簕	tfct
簙	tfdg
簛	tfek
郵	tffc
垂	tffk
甀	tffy
千	tfg
箕	tfh
簊	tfj
竿	tfl
篝	tfmj
簳	tfnf
籖	tfnk
簧	tfnw
忎	tfpu
箶	tfq
篏	tfqw
臿	tfrj
歃	tfrq
敮	tfrv
籆	tfrv
箬	tfsb
埀	tfuj
乖	tfux
簸	tfvv
笹	tfx
手	tg
箍	tgam
鹅	tgaq
我	tgat
筘	tgb
箉	tgbc
劧	tgct
箝	tgfj
簼	tgfm
簎	tgfn
	tgii
拜	tgkh
籒	tgkn
看	tgm
籜	tgmu
籀	tgqn
篺	tgrf
掱	tgtt
箨	tgvj
筢	tgvn
掰	tgwt
搿	tgwt
籡	tgww
生	th
筭	thf
籍	thfn
筹	thgy
篲	thhv
筙	thi
眚	thm
箦	thmw
箺	thn
甥	thnc
箐	thq
甡	thth
甧	thtq
箃	thvy
竹	ti
笵	tic
筂	ticl
簿	tidg
篊	tifw
丿	tiii
簹	tinb
簜	tine
篞	tinj
筲	tiq
箾	tiqn
箔	tirn
箵	titm
箲	titq
筜	tivh
箥	tivv
簗	tiwd
籓	tiwn
箈	tixb
告	tj
秸	tjb
籉	tjba
郜	tjc
筇	tjc
笻	tjc
勂	tjct
竺	tjg
等	tjgy
邾	tjic
壬	tjii
鼄	tjip
鴸	tjiq
朱	tjiw
筀	tjj
篈	tjjg
笁	tjl
築	tjmd
制	tjmn
製	tjmq
掣	tjmt
篢	tjmw
筑	tjmy
箸	tjn
靠	tjnf
酂	tjqc
酇	tjqc
先	tjqg
赞	tjqm
劗	tjqn
兟	tjqq
筠	tjqu
鹄	tjqx
勧	tjrc
歓	tjrq
観	tjrq
頶	tjsw
籌	tjvg
簭	tjwb
劮	tjwc
失	tjwg
簮	tjwn
怣	tjwp
鴩	tjwq
筮	tjww
篕	tjxm
丢	tjxy
午	tk
笴	tkb
籁	tkbm
簌	tkbq
乞	tkcg
刉	tkcn
笄	tkf
鄦	tkfc
橆	tkfd
乗	tkfi
剰	tkfn
無	tkfo
鷡	tkfq
舞	tkft
甒	tkfy
竽	tkg
	tkii
尓	tkiw
玍	tkj
啎	tkkb
乍	tklg
篶	tklo
怎	tklp
勳	tkmc
策	tkmi
箣	tkmn
熏	tkmo
籭	tkmy
動	tknc
重	tknj
濌	tknn
勲	tkno
憅	tknp
复	tknt
筻	tknw
幷	tksf
筓	tksf
甁	tksy
年	tktj
鵇	tktq
秉	tkvi
箑	tkvl
籋	tkww
勄	tkxc
瀪	tkxi
鳘	tkxk
鰵	tkxo
慜	tkxp
毓	tkxr
敏	tkxt
每	tkxu
繁	tkxx
牛	tl
牫	tlat
吿	tlb
笘	tlb
牠	tlcl
牞	tlct
犍	tlcv
牣	tlcy
牺	tldg
牯	tlfb
犆	tlfm
犕	tlfm
犊	tlfs
牜	tlii
牡	tlj
特	tljg
犢	tljm
牾	tlkb
牼	tlkj
箎	tlmg
犅	tlmm
牭	tlmn
犑	tlms
犋	tlmw
犤	tlmx
犦	tlni
籚	tlnm
牰	tlno
簴	tlnw
犗	tlpb
牸	tlpc
犏	tlpf
物	tlqe
觕	tlqm
惣	tlqp
犓	tlqx
牴	tlqy
犄	tlsb
牻	tlse
犡	tlsy
牦	tlta
犞	tltb
犐	tltf
牲	tlth
牿	tltj
牪	tltl
牬	tltt
犇	tltt
犔	tltu
牧	tltw
犠	tlua
犧	tlua
犈	tluc
犪	tlut
犌	tlvv
牷	tlwh
牝	tlx
犙	tlxe
牳	tlxu
犣	tlxx
牤	tlya
犒	tlyb
牥	tlyc
犉	tlyc
犝	tlyj
牨	tlym
犥	tlyo
犜	tlyt
舌	tm
簚	tmam
篾	tmay
卸	tmc
卹	tmc
缷	tmc
筯	tmct
衂	tmcy
罈	tmdf
缽	tmdk
缿	tmeb
衇	tmeq
算	tmf
甜	tmfj
筁	tmfk
憇	tmfp
罐	tmfr
衊	tmfy
凢	tmg
笡	tmh
衈	tmhd
缶	tmii
衆	tmio
篎	tmit
罉	tmit
甪	tmj
稠	tmjb
簓	tmje
缸	tmjl
睾	tmju
筒	tmkb
舔	tmki
缻	tmky
币	tml
罏	tmlm
罅	tmlu
笜	tmm
舑	tmmj
笧	tmmk
罁	tmmm
籰	tmmv
簤	tmmw
血	tmn
笽	tmn
舓	tmne
刮	tmng
罎	tmnx
舕	tmoo
罀	tmoq
缹	tmow
舐	tmqa
笕	tmqg
欫	tmqw
欰	tmqw
缼	tmqw
鸹	tmqx
箩	tmqy
憩	tmrp
篹	tmsc
衃	tmsl
篅	tmsm
頢	tmsw
篡	tmsx
纂	tmsx
簒	tmsx
籑	tmsy
衉	tmtb
舙	tmtt
敌	tmtw
缾	tmuf
罇	tmug
衅	tmuj
衄	tmvf
缺	tmvw
筫	tmw
笍	tmwg
箆	tmwx
乱	tmx
屲	tmx
舏	tmxl
罆	tmxm
籮	tmxr
竼	tmy
辞	tmyf
甶	tnb
篳	tnfj
筸	tnfl
笪	tnk
筛	tnkm
箅	tnkr
笛	tno
笚	tnp
馝	tnpt
篂	tnth
篮	tntm
箟	tnxx
簩	tooc
筄	toqg
筷	tovw
乏	tp
簄	tpbv
笾	tpct
筞	tpd
簺	tpfj
箜	tpjl
筦	tpjq
簆	tpjv
箮	tpkk
籧	tpls
簻	tpmb
篇	tpmf
箢	tpqc
鴔	tpqx
篧	tprl
籩	tpry
篴	tpse
篷	tpth
簉	tptj
管	tpv
簶	tpvh
龜	tpx
笱	tqb
筋	tqct
箙	tqcv
笏	tqe
筍	tqn
箰	tqnc
簲	tqrf
篼	tqrq
簷	tqsy
笷	tqtc
笉	tqu
籐	tqui
籘	tqux
笣	tqv
筝	tqvl
稳	tqvp
篘	tqxx
笂	tqy
符	tr
筏	trat
笩	tray
筗	trbl
箄	trfg
符	trgy
篁	trh
篟	trhq
箯	trkw
籅	trkw
篠	trld
筱	trlt
簰	trrf
筰	trtl
篌	trvt
篗	trvy
篦	trwx
矢	ts
榘	tsad
矩	tsav
知	tsb
呑	tsb
喬	tsbb
勪	tsbc
聟	tsbh
智	tsbn
鼅	tsbp
鷮	tsbq
敿	tsbt
敽	tsbv
矪	tseu
矱	tsfv
圱	tsj
短	tsku
岙	tsmx
刋	tsng
鴁	tsqx
鴙	tsqx
乔	tsr
雉	tsrl
笼	tst
籠	tst
矯	tstb
矫	tstr
矨	tsts
矮	tstx
簝	tsui
矰	tsun
矧	tsvl
叐	tsvy
谸	tswb
矬	tswj
筴	tsww
夭	tsy
笔	tta
笿	ttb
筿	ttd
箠	ttfk
笙	tth
筶	ttj
箽	ttkj
笮	ttlg
筈	ttm
筣	ttng
篍	ttow
筅	ttqg
籫	ttqm
簃	ttqq
笶	tts
簥	ttsb
笑	ttsy
笗	ttu
篩	ttvm
笫	ttxt
乊	tu
箞	tuc
乥	tucg
乯	tucg
乎	tuk
籣	tuki
简	tun
簡	tun
箪	tunf
悉	tupu
箭	tuqn
篓	tuxk
籔	tuxt
簢	tuyg
笃	tv
篤	tv
笢	tvag
箼	tvaj
節	tvc
蠞	tvcl
阜	tvfg
顊	tvfs
箓	tvh
篜	tvio
箫	tvir
師	tvkm
簦	tvku
筆	tvl
蛗	tvl
歸	tvlm
簫	tvlr
第	tvlt
篃	tvm
筩	tvmj
帥	tvml
簋	tvmn
峊	tvmx
笆	tvn
箒	tvpm
鴭	tvqx
笰	tvr
頧	tvsw
笋	tvt
簈	tvtf
箳	tvuf
簘	tvur
篛	tvuu
簨	tvvw
籛	twaa
篯	twat
答	twb
籥	twbf
籨	twbq
籲	twbs
籢	twbt
簽	twbw
筟	twck
务	twct
条	twd
筌	twh
夆	twhl
攵	twii
夂	twii
夊	twii
签	twik
咎	twlb
处	twlg
昝	twln
処	twmg
备	twnb
劄	twng
箚	twng
惫	twnp
笭	twp
筡	twt
夅	twtj
籦	twtj
籂	twtm
冬	twu
夈	twud
螽	twul
篒	twv
籙	twvh
箏	twvl
籤	twwk
笅	twwy
筨	twyb
篬	twyb
笒	twyv
系	tx
笞	txb
筎	txb
笲	txf
箹	txqy
篆	txse
籎	txtv
簖	txue
笯	txvy
笓	txx
篸	txxe
籪	txxe
筚	txxf
么	txy
笖	txyw
入	ty
笀	tya
箁	tyb
篙	tybb
篰	tybc
簑	tybq
籇	tybs
籝	tyby
籯	tyby
簱	tyfh
汆	tyio
簔	tykq
兪	tykx
笇	tylg
笐	tymg
肏	tymw
屳	tymx
篭	tynx
篣	typy
鳰	tyqx
鷑	tyqx
簅	tyst
箷	tytc
籏	tytf
簇	tytt
笠	tyu
籴	tyud
糴	tyur
簾	tyuw
筤	tyv
篖	tyvb
箤	tywf
籬	tywr
箊	tywu
筊	tyww
篱	tywx
簏	tyx
为	u
冻	uaiw
痓	uaj
疟	uak
减	uakb
冴	ual
疨	ual
痐	ubb
癉	ubbf
癌	ubbm
痼	ubfb
冲	ubl
总	ubpu
况	ubqg
疻	ubw
疗	uc
疖	uc
兯	uc
痂	ucb
瘸	ucbw
疡	uce
痾	uckb
疓	ucp
瘾	ucqp
癃	uctt
瘳	ucwe
癮	ucwp
癊	ucwx
为	ucy
米	ud
糮	udam
糣	udan
粔	udav
糰	udbg
籸	udcf
籽	udck
籾	udcy
痳	udd
凓	udd
痲	udd
粞	uddg
凚	uddj
糯	udds
粄	udev
籵	udfg
粸	udfh
糷	udfi
粓	udfj
糚	udfj
糒	udfm
糊	udfq
糢	udfs
糤	udft
粪	udfw
糀	udfx
糂	udfx
鷷	udgq
尊	udgy
粻	udha
精	udhq
糛	udij
粆	udit
凐	udj
糦	udjb
瘭	udji
粩	udjx
酋	udk
粖	udkd
糟	udkn
奠	udks
粳	udkw
粘	udlb
蠤	udll
粡	udmb
粬	udmf
籶	udmg
粗	udmh
糬	udmj
粣	udmk
粯	udmq
糫	udmq
籼	udmx
畨	udnb
癗	udnb
粿	udnd
糃	udne
粴	udnj
糧	udnj
粙	udno
糞	udnw
糄	udpf
粽	udpj
糘	udps
糙	udpt
粐	udpv
翷	udqc
鄰	udqc
斴	udqe
粅	udqe
粋	udqf
粦	udqt
粷	udqu
粼	udqx
甐	udqy
粺	udrf
癨	udrl
粕	udrn
糗	udrs
糇	udrt
粝	udsc
糆	udsj
糎	udsj
粫	udsm
粨	udsn
類	udss
糥	udss
猷	udsu
頪	udsw
类	udsy
奠	udsy
粏	udsy
糲	udsy
籷	udta
粍	udta
籺	udtc
粚	udtc
粁	udtf
糌	udtn
敉	udtw
痡	udu
料	uduf
糋	udun
糕	uduo
糍	udux
糅	udvd
粈	udvf
粶	udvh
糨	udvl
粑	udvn
糈	udvq
糑	udvu
粎	udvy
粭	udwb
粉	udwc
糩	udwn
糉	udwt
糭	udwt
凇	udwx
数	udx
糁	udxe
娄	udxk
鷜	udxq
纇	udxs
颣	udxs
数	udxt
粃	udxx
甊	udxy
糖	udyb
粹	udyf
糠	udyi
粧	udyj
粇	udym
糡	udyq
粒	udyu
粮	udyv
麊	udyx
癓	uemt
癥	uemt
瘢	uemv
癁	uett
瘲	uewl
瘽	ufbh
癱	ufbr
乧	ufcg
凘	ufek
瘔	uffb
斗	ufg
疳	ufj
癫	ufms
瘨	ufmw
瘄	ufn
瘼	ufns
癀	ufnw
癘	ufny
痨	ufpc
瘩	ufwb
疶	ufx
瘎	ufx
疛	ugy
羊	uh
痮	uha
羬	uhab
羢	uhas
翔	uhcc
瘛	uhcp
瘈	uhcs
劷	uhct
羺	uhds
羏	uhe
羵	uhfm
兰	uhg
	uhii
	uhii
羨	uhiq
差	uhjl
羥	uhkj
凑	uhks
羠	uhkw
着	uhm
盖	uhmn
羰	uhmo
羖	uhmv
羯	uhnw
羹	uhos
羔	uhow
羫	uhpj
羜	uhpk
羦	uhpq
恙	uhpu
凊	uhq
鲝	uhqk
鮺	uhqo
鯗	uhqo
鴹	uhqx
羝	uhqy
养	uhr
羱	uhsi
美	uhsy
羲	uhta
善	uhub
鄯	uhuc
羡	uhuq
敾	uhut
羴	uhuu
羞	uhvf
羟	uhvj
羓	uhvn
羛	uhvr
羒	uhwc
羭	uhwn
羳	uhwn
羚	uhwp
羷	uhww
羌	uhx
姜	uhxk
羧	uhxt
羗	uhxx
癍	uhyh
羕	uhyi
羶	uhyk
羻	uhyt
羪	uhyv
養	uhyv
譱	uhyy
疒	uiii
冫	uiii
丷	uiii
痧	uiit
冰	uio
痟	uiq
半	uj
卷	ujc
勌	ujcc
痚	ujck
券	ujco
劵	ujct
桊	ujd
叛	ujev
痔	ujgy
	ujii
冮	ujl
疘	ujl
齤	ujlw
眷	ujm
帣	ujml
凟	ujmm
瘏	ujn
判	ujng
鵥	ujnq
痣	ujpu
鲞	ujqk
觠	ujqm
鮝	ujqo
奍	ujr
豢	ujse
頖	ujsw
拳	ujtg
牶	ujtl
駦	ujv
巻	ujvk
韏	ujvt
弮	ujvx
凌	ujwt
餋	ujwv
疞	ujx
絭	ujx
勬	ujxc
誊	ujy
飬	ujyv
疴	ukb
凁	ukbi
癞	ukbm
瘌	ukbn
瘶	ukbq
瘷	ukbt
痘	ukbu
疠	ukct
并	ukf
剙	ukfc
郱	ukfc
鵧	ukfq
頩	ukfs
艵	ukfv
瓶	ukfy
兿	ukgx
疔	ukl
疜	uklg
症	ukll
夔	uklt
病	ukmw
冽	ukng
凍	ukni
普	uknn
癋	uknp
痖	uknu
剪	ukqc
翦	ukqc
前	ukqn
煎	ukqo
馘	ukrk
首	ukrm
郑	uksc
关	uksy
瘗	ukuj
痦	ukvb
痍	ukvw
凄	ukvx
蠲	ukwl
益	ukwm
鷁	ukwq
鹢	ukwq
孳	ukxc
槊	ukxd
塑	ukxj
冱	ukxk
屰	ukxl
慈	ukxp
朔	ukxq
鹚	ukxq
欮	ukxq
鶿	ukxq
鷀	ukxq
兹	ukxx
甆	ukxy
丫	ul
痋	ul
瘧	ulak
痁	ulb
丬	ulii
壮	ulj
装	uljq
酱	ulqd
桨	ulqd
将	ulqg
浆	ulqi
螀	ulql
奖	ulqs
状	ulsu
醤	ulwd
奨	ulws
疵	ulx
妆	ulxk
癑	umfs
痶	umfw
疽	umh
弊	umif
鳖	umik
蹩	umil
瞥	umim
暼	umin
瘝	umio
鱉	umio
憋	umip
鷩	umiq
獘	umis
敝	umit
彆	umiv
鄨	umiv
鐅	umiw
斃	umix
嫳	umix
痈	umj
癦	umj
凋	umjb
凙	umju
痌	umkb
癏	umkq
凒	umku
癯	ummr
瘿	ummx
曾	umn
鄫	umnc
朆	umne
甑	umny
凗	umrl
瘋	umtl
疫	umv
瘑	umvb
疯	umwy
疝	umx
痱	unf
郸	unfc
单	unfg
冁	unfq
兾	unfw
疸	unk
兽	unkb
瘍	unke
痹	unkr
痩	unlv
瘟	unmn
曽	unn
癳	unnx
痬	unqe
瘰	unx
癆	uooc
痰	uoow
疢	uow
瘠	uowq
门	up
瘒	upaf
閳	upaf
阈	upak
閕	upal
问	upb
問	upb
闾	upbb
阃	upbd
闡	upbf
闠	upbm
阓	upbm
閮	upct
闲	upd
閑	upd
閪	updg
闉	updj
鹇	updq
闄	updx
闬	upfl
閈	upfl
闀	upfv
阗	upfw
闭	upgt
闰	uph
閏	uph
闻	uphd
闫	uphg
閠	uphy
門	upii
鬥	upii
闛	upij
闣	upin
閖	upio
阔	upit
闱	upjc
闺	upjj
阖	upjm
闍	upjn
阇	upjn
闚	upjq
闩	upk
閂	upk
閜	upkb
開	upkf
闘	upkg
鬪	upkg
阑	upki
閅	upkl
閇	upkl
閸	upkn
閛	upku
闽	upl
閩	upl
闏	upml
闤	upmq
阛	upmq
阒	upms
闝	upmt
闓	upmu
闦	upmu
闿	upmv
闅	upmv
閴	upmw
閊	upmx
间	upn
間	upn
闒	upnc
阘	upnc
鬬	upne
鬭	upne
阊	upnn
闸	upnp
覸	upnq
鷼	upnq
凕	upnw
閺	upny
焛	upow
闙	uppb
闧	uppq
闼	upps
閟	uppt
闙	uppt
闷	uppu
閒	upq
	upql
	upql
阍	upqn
覵	upqq
鷳	upqq
阎	upqr
阄	upqx
阀	upra
闑	uprd
闎	upri
閰	uprj
閵	uprl
阋	uprq
阉	upsx
闳	upsx
閎	upsx
閹	upsx
閁	upt
閐	upta
阁	uptb
鬮	uptp
闂	upuc
阐	upuf
闁	upup
阅	upuq
阙	upuq
閲	upuq
闕	upuq
関	upus
闯	upv
痯	upv
闖	upv
阕	upvs
阚	upvt
闢	upvy
閤	upwb
闟	upwc
闪	upwg
	upwj
	upwj
閝	upwp
閱	upwq
阌	upwv
閦	upww
閞	upxf
闗	upxo
關	upxx
訚	upy
誾	upy
閍	upyc
闵	upyg
闹	upym
闶	upym
閙	upym
鬧	upym
閌	upym
闇	upyn
阏	upyu
阆	upyv
阂	upyw
兑	uq
疧	uqag
痻	uqan
疷	uqay
咨	uqb
痀	uqb
楶	uqbd
凂	uqbq
乲	uqcg
瘤	uqcn
栥	uqd
疩	uqfg
垐	uqj
瘵	uqji
癣	uqku
瓷	uqky
盗	uqmn
痪	uqms
资	uqmw
癬	uqou
恣	uqpu
痭	uqq
痑	uqqy
癚	uqsy
秶	uqtd
敚	uqtw
粢	uqud
疱	uqv
净	uqvl
次	uqw
餈	uqwv
姿	uqxk
疚	uqy
瘣	urb
凖	urfg
痺	urfg
准	url
痽	url
癄	urow
瘜	urpu
瘊	urvt
瘦	urvy
癟	urwf
瘐	urwg
瘪	urwx
癙	urxg
痞	usb
疬	usct
瘃	use
痝	use
痷	usnx
痏	usq
癧	ustl
療	usui
冹	usvy
瘞	uswj
瘱	uswp
疣	usx
头	usy
凞	utao
痴	utb
疙	utcg
痵	utck
癪	uthm
瘇	utkj
痄	utlg
痜	utmg
痸	utmn
痢	utng
疺	utp
冼	utqg
疾	uts
疼	utu
癤	utvc
痿	utxk
痗	utxu
痫	uud
痒	uuh
冸	uuj
瘥	uujl
癎	uun
瘅	uunf
痥	uuq
癇	uuq
瘘	uuxk
瘚	uuxq
癢	uuyv
冯	uv
馮	uv
冺	uvag
癖	uvby
瘺	uvdo
癜	uvfm
慿	uvfp
瘬	uvha
痉	uvj
瘕	uvjv
冿	uvl
弚	uvl
剃	uvln
鹈	uvlq
弟	uvlt
凴	uvmg
痛	uvmj
疤	uvn
帰	uvpm
憑	uvpu
痕	uvq
疿	uvr
瘫	uvrl
疲	uvv
癈	uvvm
為	uvvo
决	uvwg
痆	uvx
瘙	uvyl
兼	uw
凎	uw
冾	uwb
疮	uwc
疹	uwe
痊	uwh
甉	uwky
癐	uwmn
冷	uwp
瘉	uwqn
癒	uwqp
歉	uwqw
鹣	uwqx
瘹	uwqy
疥	uwr
凃	uwt
飡	uwv
凈	uwvl
疭	uwwg
痤	uwwj
凔	uwyb
瘡	uwyb
北	ux
疕	ux
軰	uxaf
冶	uxb
癰	uxbr
邶	uxc
丠	uxk
冀	uxnw
背	uxq
鄁	uxqc
兠	uxrq
瘆	uxse
凝	uxtv
痠	uxwt
疪	uxx
瘮	uxxe
癴	uxyt
癵	uxyw
凉	uybi
凛	uybj
凜	uybt
癛	uybt
癠	uycr
瘴	uyfg
疰	uyh
瘖	uyn
癔	uypu
瘯	uytt
瘁	uywf
瘀	uywu
癕	uyxr
痎	uyxw
痃	uyxx
展	v
驅	vabb
駴	vaf
駤	vaj
戼	vakv
駥	vas
骁	vasx
駏	vav
驱	vawy
驒	vbbf
駰	vbg
骃	vbg
馽	vbl
駽	vbq
韗	vbta
郼	vbtc
韕	vbtc
韎	vbtd
韖	vbtd
韘	vbtd
韚	vbtf
韟	vbtf
韔	vbth
韋	vbtj
韠	vbtj
韡	vbtj
韣	vbtl
韛	vbtm
韝	vbtm
韞	vbtm
韥	vbtm
韢	vbtp
韒	vbtq
韜	vbtr
韐	vbtw
韍	vbty
韤	vbty
韌	vbty
驶	vbwy
予	vc
駋	vcb
驰	vcl
馳	vcl
书	vcly
豫	vcqs
騽	vcrn
预	vcsw
矛	vct
矞	vctb
務	vctc
柔	vctd
鞪	vctf
堥	vctj
蟊	vctl
蝥	vctl
駳	vctl
瞀	vctm
劀	vctn
暓	vctn
矠	vctn
熃	vcto
愗	vctp
鹜	vctq
鹬	vctq
矟	vctq
鶔	vctq
鶩	vctq
鷸	vctq
奦	vcts
敄	vctt
氄	vctt
矜	vctv
骛	vctv
矡	vctv
騖	vctv
鍪	vctw
婺	vctx
騛	vcuu
騝	vcvl
馺	vcy
尸	vd
屋	vdaj
剭	vdan
劈	vdbc
孹	vdbc
檗	vdbd
壁	vdbj
躄	vdbl
屌	vdbm
幦	vdbm
鼊	vdbp
憵	vdbp
臂	vdbq
襞	vdbq
鷿	vdbq
鸊	vdbq
	vdbq
礕	vdbs
擘	vdbt
糪	vdbu
鐾	vdbw
嬖	vdbx
繴	vdbx
譬	vdby
辟	vdby
璧	vdby
甓	vdby
局	vdcb
屙	vdcb
孱	vdcc
杘	vdd
驦	vddm
骦	vddm
屚	vddo
屩	vdeb
屧	vded
屣	vdel
履	vdet
屐	vdev
屜	vdex
屦	vdex
屨	vdex
居	vdfb
屟	vdfd
壂	vdfj
殿	vdfm
剧	vdfn
臀	vdfq
鶋	vdfq
展	vdfq
臋	vdfw
屉	vdfx
斸	vdie
屬	vdil
劚	vdin
尿	vdio
屑	vdiq
犀	vdit
尉	vdjg
骠	vdji
螱	vdjl
屠	vdjn
熨	vdjo
慰	vdjp
褽	vdjq
鷵	vdjq
犚	vdjt
叞	vdjv
层	vdjx
屍	vdkx
凥	vdmg
屈	vdmm
屭	vdmm
刷	vdmn
鶌	vdmq
屃	vdmw
屓	vdmw
屇	vdnb
驔	vdnf
屝	vdnf
届	vdno
屪	vdpi
屄	vdpw
尻	vdqt
鳲	vdqx
鸤	vdqx
屒	vdsj
尾	vdta
屘	vdtc
屛	vdtf
屗	vdtg
属	vdty
屎	vdud
屏	vduf
層	vdun
羼	vduu
屡	vdux
屢	vdux
騋	vdww
尼	vdx
屫	vdxb
騕	vdxk
屁	vdxx
尺	vdy
屖	vdyf
昼	vdyk
尽	vdyu
咫	vdyw
馸	vek
駈	vek
屣	vell
丑	vf
馵	vf
騹	vfbh
驖	vfbh
驩	vfbr
骐	vfh
騏	vfh
驊	vfkj
馯	vfl
殿	vfm
殿	vfmv
騲	vfnf
驧	vfqu
驠	vfuo
馶	vfvy
殿	vfwm
臀	vfwq
录	vh
駬	vhd
聼	vhfp
彟	vhgv
寻	vhgy
彐	vhii
隶	vhio
鹔	vhiq
肃	vhir
鄩	vhjc
尋	vhjg
晝	vhjk
畫	vhjk
劃	vhjn
書	vhjn
彠	vhjv
畵	vhjx
肀	vhl
	vhlk
盡	vhlm
賮	vhlm
歗	vhlq
鷫	vhlq
肅	vhlr
帇	vhml
盝	vhmn
剥	vhng
灵	vhow
彚	vhpd
帚	vhpm
夛	vhqy
騞	vhs
尹	vht
君	vhtb
郡	vhtc
帬	vhtm
焄	vhto
憨	vhtp
裠	vhtq
覠	vhtq
鵘	vhtq
頵	vhts
群	vhtu
敢	vhtw
彛	vhuf
彞	vhuf
粛	vhur
骤	vhvi
马	vi
承	vihg
乛	viii
馬	viii
丞	vik
卺	vikc
烝	viko
脀	vikq
巹	vikv
騨	vinf
氶	vio
駲	vir
駫	visx
函	vixl
顄	vixs
劲	vjct
驍	vjjs
刭	vjng
驝	vjpd
颈	vjsw
叚	vjvv
巯	vjyr
己	vk
駷	vkbi
邔	vkc
馷	vkml
骊	vkmy
驑	vknn
鵋	vkpq
忌	vkpu
駵	vktv
改	vktw
駍	vkuk
妀	vkxk
聿	vlii
疋	vlii
疎	vlki
蛋	vll
	vll
疍	vlnk
驢	vlnm
驉	vlnu
胥	vlq
衋	vlsm
叏	vlvy
疏	vlyr
駉	vmb
驵	vmh
駔	vmh
騆	vmjb
驛	vmju
駧	vmkb
驷	vmn
駟	vmn
驨	vmrb
駚	vmsy
颿	vmtl
騧	vmvb
巴	vn
驲	vn
馹	vn
巼	vnbx
骒	vnd
騍	vnd
騑	vnf
驆	vnfj
駻	vnfl
騠	vnkl
骋	vnkx
岊	vnmx
駎	vno
騦	vnpu
騴	vnpx
騔	vnqw
驜	vnuh
骡	vnx
騾	vnx
騉	vnxx
已	vo
駣	voqg
巳	vp
民	vpag
蟁	vpal
睯	vpam
刡	vpan
昬	vpan
暋	vpan
愍	vpap
鴖	vpaq
敃	vpat
敯	vpav
骟	vpcc
异	vpf
导	vpgy
騌	vpji
骔	vpji
驞	vpkm
骗	vpmf
馾	vpqg
駜	vpt
攺	vptw
驴	vpv
馿	vpv
巽	vpvw
驼	vpx
駝	vpx
槩	vqad
塈	vqaj
暨	vqak
鱀	vqao
既	vqaq
驹	vqb
駒	vqb
即	vqc
堲	vqcj
骝	vqcn
騘	vqep
艮	vqii
垦	vqj
駨	vqn
恳	vqpu
鵖	vqqx
駠	vqtc
騊	vqtm
驺	vqvh
騶	vqxx
馰	vqy
驯	vr
馴	vr
騩	vrb
驸	vrgy
騜	vrh
騡	vrio
骓	vrl
騅	vrl
骢	vrtp
騪	vrvy
骅	vrxf
駹	vse
駓	vsk
骑	vskb
騵	vsri
騻	vsww
駀	vsx
驮	vsy
馱	vsy
駄	vsy
尸	vt
馲	vtag
屋	vtaj
剭	vtan
騀	vtat
骆	vtb
駱	vtb
劈	vtbc
檗	vtbd
壁	vtbj
躄	vtbl
屌	vtbm
幦	vtbm
憵	vtbp
鼊	vtbp
臂	vtbq
襞	vtbq
鷿	vtbq
鸊	vtbq
	vtbq
礕	vtbs
擘	vtbt
糪	vtbu
鐾	vtbw
嬖	vtbx
辟	vtby
譬	vtby
璧	vtby
甓	vtby
局	vtcb
屙	vtcb
孱	vtcc
駞	vtcl
杘	vtd
屚	vtdo
屩	vteb
屧	vted
屣	vtel
履	vtet
屐	vtev
屦	vtex
居	vtfb
屟	vtfd
壂	vtfj
殿	vtfm
剧	vtfn
臀	vtfq
展	vtfq
鶋	vtfq
臋	vtfw
屉	vtfx
斸	vtie
屬	vtil
劚	vtin
尿	vtio
屑	vtiq
犀	vtit
駯	vtiw
尉	vtjg
螱	vtjl
屠	vtjn
熨	vtjo
慰	vtjp
褽	vtjq
鷵	vtjq
犚	vtjt
叞	vtjv
层	vtjx
騈	vtkf
屍	vtkx
眉	vtm
郿	vtmc
凥	vtmg
屈	vtmm
刷	vtmn
鹛	vtmq
屃	vtmw
屓	vtmw
屇	vtnb
屝	vtnf
届	vtno
屪	vtpi
屄	vtpw
駪	vtqg
尻	vtqt
鳲	vtqx
鸤	vtqx
驕	vtsb
屒	vtsj
骄	vtsr
尾	vtta
屘	vttc
屛	vttf
屗	vttg
属	vtty
屎	vtud
屏	vtuf
層	vtun
羼	vtuu
屡	vtux
駇	vtw
尼	vtx
屫	vtxb
屁	vtxx
尺	vty
屖	vtyf
昼	vtyk
尽	vtyu
咫	vtyw
骈	vuf
駢	vuf
驓	vumn
骥	vunw
駾	vuq
騚	vuqn
驎	vuqt
买	vusy
驣	vuv
皮	vv
騳	vv
駶	vvcb
骣	vvcc
皯	vvfl
巽	vvfw
騄	vvh
骕	vvir
驿	vvjl
騢	vvjv
騤	vvks
骙	vvks
騒	vvl
驌	vvlr
皹	vvpa
駸	vvpv
骎	vvpv
皰	vvqv
颇	vvsw
驈	vvtb
騥	vvtd
駊	vvv
驫	vvv
骉	vvv
驋	vvvm
駃	vvwg
驭	vvy
馭	vvy
駅	vvy
骚	vvyl
験	vwbw
驗	vwbw
駗	vwe
夬	vwg
駩	vwh
验	vwik
刔	vwng
駖	vwp
騟	vwqn
鴂	vwqx
駼	vwt
騇	vwtm
驳	vwwy
騱	vwxs
騣	vwxt
騐	vwyp
弓	vx
弫	vxa
弬	vxa
彄	vxab
弡	vxav
骀	vxb
駘	vxb
勥	vxbc
彈	vxbf
强	vxbl
弲	vxbq
犟	vxbt
謽	vxby
弨	vxcb
弛	vxcl
弧	vxex
弽	vxfd
彉	vxfw
张	vxha
弭	vxhd
弾	vxif
弰	vxiq
疆	vxjk
弖	vxk
彁	vxkb
弙	vxkg
弳	vxkj
彊	vxkk
弻	vxkv
彌	vxkw
瓕	vxky
引	vxl
弔	vxl
盄	vxlm
彋	vxmq
彏	vxmv
彃	vxnj
舝	vxpt
馻	vxqg
弥	vxqi
弸	vxqq
弞	vxqw
弤	vxqy
弗	vxr
鄪	vxrc
弣	vxrg
费	vxrm
刜	vxrn
艴	vxrv
骖	vxse
弼	vxsv
矤	vxts
騃	vxts
彅	vxuc
弹	vxuf
鶸	vxuq
弱	vxuu
鬻	vxuu
粥	vxuv
弪	vxvj
弝	vxvn
彇	vxvr
弜	vxvx
骏	vxwt
驂	vxxe
強	vxxl
弢	vxxv
弘	vxxy
弴	vxyc
弶	vxyi
彍	vxyw
弦	vxyx
又	vy
戏	vyat
驙	vybk
骧	vybq
驐	vybt
圅	vybu
邓	vyc
劝	vyct
騂	vyf
骍	vyf
騿	vyfg
癷	vyfl
馼	vyg
怼	vygp
对	vygy
驻	vyh
駐	vyh
癶	vyii
	vyii
圣	vyj
発	vyjq
頚	vyjs
戣	vyka
鄈	vykc
鄧	vykc
凳	vykm
覴	vykq
癸	vyks
登	vyku
勇	vymc
甬	vymj
恿	vymp
观	vymq
癹	vymv
騯	vypy
欢	vyqw
鸡	vyqx
难	vyrl
駺	vyv
桑	vyvd
叠	vyvm
剟	vyvn
艰	vyvq
颡	vyvs
毲	vyvt
敪	vyvt
叒	vyvv
叕	vyvv
敠	vyvv
双	vyvy
駮	vyww
騼	vyx
骇	vyxw
叉	vyy
蚤	vyyl
八	w
錢	waat
钷	wab
鉕	wab
鏂	wabb
鑎	wabm
铖	wac
铘	wac
鋣	wac
鋮	wac
鏩	waek
銍	waj
铚	waj
鉽	wajl
銊	wak
鍼	wakb
釾	wal
	wal
鏚	wali
鉔	waml
铽	wapu
鐕	waqn
铙	wasx
钱	wat
鈛	wat
銭	wat
鑑	watm
鑬	watq
钜	wav
鉅	wav
鏗	wavj
鑦	wavm
钺	wax
鉞	wax
錷	wax
釴	way
合	wb
釦	wb
铝	wbb
鋁	wbb
鐰	wbbd
鋛	wbbl
锷	wbbx
郃	wbc
翕	wbcc
歙	wbcq
樖	wbdb
盫	wbdm
弇	wbf
锢	wbfb
铟	wbg
銦	wbg
锃	wbh
鋥	wbh
鍓	wbhd
鋘	wbks
钟	wbl
鈡	wbl
鋜	wbll
鐀	wblm
鏴	wblt
敆	wblv
铞	wbml
盒	wbmn
锅	wbmw
畣	wbnb
鋗	wbq
兌	wbqg
敓	wbqt
欱	wbqw
鸽	wbqx
龛	wbst
颌	wbsw
拿	wbtg
搻	wbtt
鉙	wbw
鉂	wbwy
钌	wc
釕	wc
仓	wc
鉊	wcb
鉫	wcb
鉰	wcb
兺	wcbx
郛	wcc
邠	wcc
钖	wce
弅	wcf
钇	wcg
釔	wcg
坌	wcj
孚	wck
釨	wck
锕	wckb
瓫	wcky
蚠	wcl
釶	wcl
盆	wcmn
锰	wcmn
錳	wcmn
贫	wcmw
岔	wcmx
鐊	wcne
创	wcng
分	wco
刅	wco
釖	wco
炃	wcow
釢	wcp
忿	wcpu
鳻	wcqx
鑃	wcrl
颁	wcsw
办	wct
釛	wct
嗠	wctb
铤	wctj
鋋	wctl
攽	wctw
键	wcvl
鏐	wcwe
镠	wcwe
乳	wcx
釰	wcy
釼	wcy
鈒	wcy
钑	wcy
麄	wcyx
采	wd
鈢	wd
彩	wde
鎛	wdgy
鏄	wdgy
镈	wdgy
釆	wdii
镖	wdji
钵	wdk
鉢	wdk
釋	wdmu
镭	wdnb
镡	wdnf
釉	wdno
錰	wdow
悉	wdpu
鑐	wdsm
铺	wdu
鋪	wdu
释	wdvj
釈	wdvy
鑻	wdwt
錸	wdww
鉥	wdy
钐	we
釤	we
貙	weab
貚	webf
貂	wecb
鑕	weem
貈	weeu
豻	wefl
鍎	wefm
锧	wefm
貓	wefn
貛	wefr
貘	wefs
豺	wegt
釽	wei
豸	weii
釿	wek
銗	wekb
貆	wekk
鋲	wekw
貀	wemm
貒	wems
貜	wemv
豽	wemw
貋	wenf
貍	wenj
蠫	wenl
貁	wepw
豿	weqb
锨	weqw
豹	weqy
貅	werd
貏	werf
貃	wern
貌	werq
貔	werx
豾	wesk
貊	wesn
貉	wetb
貖	weum
貗	weux
墾	wevj
貄	wevl
懇	wevp
貇	wevq
貑	wevv
钣	wevy
鏦	wewl
貐	wewn
貕	wews
鈲	wex
豼	wexx
鑶	wfaa
钴	wfb
鈷	wfb
鐵	wfbh
鑵	wfbr
鐡	wfbu
鍣	wfcb
鐁	wfek
鐷	wffd
鐼	wffm
针	wfg
針	wfg
錤	wfh
鑮	wfig
钳	wfj
鉗	wfj
鑉	wfjm
鐯	wfjn
	wfjn
鏵	wfkj
釬	wfl
鍈	wfms
锳	wfms
镇	wfmw
鏋	wfmy
鑖	wfmy
错	wfn
錯	wfn
锚	wfnb
镆	wfns
鐄	wfnw
铹	wfpc
鑝	wfph
鎍	wfpx
鍸	wfq
鋴	wfqg
鏾	wfqt
镬	wfrv
錵	wfrx
锘	wfsb
钄	wfui
鈘	wfvy
鉷	wfw
鎝	wfwb
銰	wfwy
鉪	wfx
鍖	wfx
鍱	wfxd
鋩	wfya
铓	wfya
錺	wfyc
人	wg
仺	wgak
仓	wgc
戗	wgca
创	wgcn
鸧	wgcq
仐	wgfg
全	wgh
氽	wgio
尒	wgiw
舎	wgjb
郐	wgjc
舗	wgjd
佘	wgji
仝	wgjl
刽	wgjn
畲	wgjn
会	wgjx
个	wgl
企	wgll
虢	wglm
仚	wgmx
銶	wgoy
介	wgr
頱	wgsw
釮	wgt
舖	wgtd
舍	wgtm
鵨	wgtq
舒	wgtv
仒	wgu
伞	wguk
傘	wgwf
从	wgwg
耸	wgwh
坐	wgwj
丛	wgwk
俎	wgwm
剉	wgwn
怂	wgwp
夎	wgwt
众	wgww
仑	wgx
亽	wgy
寽	wgy
戧	wgya
含	wgyb
酓	wgyd
贪	wgym
創	wgyn
念	wgyp
衾	wgyq
雂	wgyr
颔	wgys
敜	wgyt
今	wgyv
禽	wgyx
韽	wgyy
鋹	wha
鑩	whbb
鎁	whc
锲	whcs
铒	whd
鉺	whd
铸	whgy
錱	whh
鑷	whhh
鏏	whhv
銇	whi
锖	whq
錆	whq
錶	whq
镊	whvv
鋷	whvy
銸	whx
钰	why
鈺	why
金	wi
铴	wice
鏿	wid
鎃	wieq
钅	wiii
镗	wij
鏜	wij
鍅	wijx
鋿	wimb
鏛	wiml
钂	wimo
锁	wimw
錔	win
鐺	winb
鐋	wine
淾	wio
鎲	wip
镋	wip
销	wiq
銷	wiq
銂	wir
銧	wisx
钞	wit
鈔	wit
鐣	witg
铛	wivh
釥	wiw
钍	wj
釷	wj
銡	wjb
鎱	wjbq
﨧	wjck
銢	wjio
銾	wjio
銈	wjj
鐃	wjjs
铐	wjkx
釭	wjl
鑟	wjmm
锗	wjn
鍺	wjn
鋕	wjpu
鈨	wjqg
﨨	wjuj
鑄	wjvg
鈇	wjwg
錴	wjwj
鑚	wjwm
鐟	wjwn
鶏	wjwq
錂	wjwt
铑	wjx
釫	wjx
銠	wjx
鎑	wjxm
鉣	wjxy
命	wk
錻	wkal
钶	wkb
鈳	wkb
鎶	wkbb
命	wkbc
龠	wkbf
鋉	wkbi
剣	wkbn
劍	wkbn
鍢	wkbn
歛	wkbq
鏉	wkbq
鸙	wkbq
龡	wkbq
龤	wkbr
顩	wkbs
龥	wkbs
斂	wkbt
龢	wkbt
镉	wkbu
龣	wkbv
僉	wkbw
剱	wkby
劒	wkby
劔	wkby
鈃	wkf
钘	wkf
鉶	wkfn
铏	wkfn
釪	wkg
亼	wkii
佥	wkik
剑	wkin
敛	wkit
佱	wkkl
钉	wkl
釘	wkl
钲	wkll
钙	wklx
鄶	wkmc
侖	wkmf
朇	wkmf
鍊	wkmi
劊	wkmn
會	wkmn
鏪	wkmn
鈵	wkmw
錬	wkni
鐂	wknn
鐚	wknp
錏	wknu
铔	wknu
錽	wkot
鋄	wkov
鄃	wkqc
俞	wkqn
愈	wkqp
觎	wkqq
毹	wkqt
銒	wksf
鶢	wksq
爰	wksv
铼	wkud
铗	wkus
鋙	wkvb
铻	wkvb
侴	wkvn
銕	wkvw
鑈	wkww
兮	wkx
鋞	wkxj
钝	wkxx
鉵	wl
鐬	wlat
钻	wlb
鉆	wlb
鏀	wlbo
钋	wlg
釙	wlg
鉲	wlkl
钀	wlks
錿	wlmg
鍞	wlmw
鐪	wlnc
鋽	wlnf
鑪	wlnm
鑢	wlnp
錹	wlq
鐻	wlse
鎼	wltg
鏬	wltu
鈙	wlvy
鑡	wlw
钢	wm
钼	wm
鉬	wm
铅	wmb
鉛	wmb
锄	wmct
錪	wmfw
釠	wmg
鉏	wmh
爯	wmj
錭	wmjb
鐸	wmju
铜	wmkb
鎠	wmkl
鐶	wmkq
镮	wmkq
鎧	wmku
鈯	wmm
銏	wmmk
銟	wmml
鑺	wmmr
钁	wmmv
	wmmv
铡	wmng
觅	wmqg
镯	wmql
鏰	wmqq
镚	wmqq
锣	wmqy
鑴	wmrb
鏙	wmrl
錌	wmsf
鍴	wmsm
鉠	wmsy
鎽	wmth
鋼	wmum
鈠	wmv
鍋	wmvb
爵	wmvg
铠	wmvk
钡	wmw
鋇	wmw
钠	wmwg
鑼	wmxr
鐤	wmxv
钒	wmy
釩	wmy
番	wn
鈤	wn
钿	wnb
鈿	wnb
鄱	wnc
翻	wncc
勫	wnct
飜	wncu
锞	wnd
錁	wnd
鑤	wnfi
鏎	wnfj
銲	wnfl
钊	wng
釗	wng
鎤	wnis
锂	wnj
鋰	wnj
钽	wnk
鉭	wnk
鍚	wnke
锝	wnkg
鍉	wnkl
鍡	wnkq
鉮	wnl
鎾	wnmn
镘	wnmv
鍝	wnmy
錩	wnn
锠	wnn
鑸	wnnj
鑘	wnnn
铀	wno
鈾	wno
钾	wnp
鉀	wnp
锶	wnpu
锡	wnqe
鍻	wnqw
鷭	wnqx
鍟	wnth
鑆	wnug
镤	wnuh
铿	wnvj
鎅	wnwr
镙	wnx
鏍	wnx
锟	wnxx
鐛	wnyi
鐒	wooc
鑅	wood
锬	woow
铫	woqg
钬	wow
鈥	wow
令	wp
链	wpaf
镩	wpbl
鑓	wpbv
邻	wpc
翎	wpcc
镔	wpew
鑳	wpfl
鑧	wpfy
锭	wpg
錠	wpg
鎋	wphb
錝	wpji
鋎	wpjq
鐽	wpju
鍹	wpkk
鑌	wpkm
鏔	wpkw
瓴	wpky
鐹	wpmb
鍽	wpmf
鎺	wpmh
刢	wpng
鑏	wppk
愛	wppt
鋺	wpqc
鈂	wpqg
镲	wpqj
舜	wpqt
鴒	wpqx
鸰	wpqx
鏥	wprn
鑹	wprx
镓	wpse
錑	wpsu
爱	wpsv
领	wpsw
鋐	wpsx
铋	wpt
鉍	wpt
鏠	wpth
鎚	wptv
鈊	wpu
鎹	wpus
鐩	wpus
鈩	wpv
錧	wpv
受	wpvy
鎔	wpwb
镕	wpwb
铊	wpx
鉈	wpx
铵	wpxk
钥	wq
鈅	wq
銽	wqab
錉	wqan
铭	wqb
鉤	wqb
銘	wqb
鋔	wqbq
鐌	wqbs
鑱	wqby
镵	wqby
镏	wqcn
锪	wqep
尣	wqg
尩	wqh
鉨	wqi
铄	wqiw
镥	wqkn
銁	wqn
钨	wqo
鎢	wqo
鑥	wqon
錋	wqq
尦	wqqy
鉹	wqqy
錎	wqrj
釚	wqt
铆	wqtc
鋾	wqtm
钧	wqu
鈞	wqu
憌	wqup
鉋	wqv
铇	wqv
铮	wqvl
铯	wqvn
钦	wqw
欽	wqw
鵭	wqx
钩	wqxy
钓	wqy
釣	wqy
釸	wqy
釻	wqy
鍧	wqy
钏	wr
釧	wr
銄	wrb
镌	wrcp
镍	wrd
銝	wrd
鎳	wrd
鏶	wrd
錍	wrfg
鎨	wrfg
鉜	wrgy
銵	wrh
鍠	wrh
锽	wrh
锻	wrhm
舀	wrj
锥	wrl
錐	wrl
鐫	wrlc
鎀	wrle
鏅	wrlq
锦	wrml
铂	wrn
鉑	wrn
鐎	wrow
鎴	wrpu
銋	wrtj
鏓	wrtp
鐭	wrus
鍭	wrvt
锼	wrvy
鎫	wrwt
鎞	wrwx
鈋	wrx
铧	wrxf
鉐	ws
鈪	wsc
锛	wsff
銔	wsfg
鎒	wsgy
鋠	wsj
錼	wsji
鍷	wsjj
銙	wsjx
鉟	wsk
錡	wskb
锜	wskb
钚	wsl
鈈	wsl
銌	wslc
钸	wsml
銆	wsn
铕	wsq
銪	wsq
鑨	wst
镣	wsui
镢	wsuq
钹	wsvy
顉	wsw
鋏	wsww
鏯	wsww
鈜	wsxy
钛	wsy
釱	wsy
鈦	wsy
余	wt
锇	wtat
铬	wtb
鉻	wtb
釳	wtcg
鉇	wtcl
锈	wtcp
鉌	wtd
钎	wtfg
锤	wtfk
锸	wtfr
鉎	wth
锋	wthl
铢	wtiw
锆	wtj
鋯	wtj
鈓	wtj
铥	wtjx
鏼	wtki
锺	wtkj
鑂	wtko
鈝	wtl
鈼	wtlg
敍	wtlv
銛	wtm
铦	wtm
鋵	wtmg
鉓	wtml
颻	wtml
嵞	wtmm
飖	wtmw
峹	wtmx
畬	wtnb
鏫	wtnd
鋓	wtng
鍑	wtnt
锹	wtow
悆	wtpu
懖	wtpu
铣	wtqg
鑽	wtqm
鑗	wtqw
鹞	wtqx
雓	wtrl
鉃	wts
鐈	wtsb
鑙	wtsn
敘	wttw
繇	wttx
鉖	wtu
厁	wtuc
鎎	wtud
斜	wtuf
噕	wtvb
爳	wtvc
鄬	wtvc
爲	wtvo
叙	wtvy
铁	wtwg
錗	wtxk
鋂	wtxu
釞	wty
锩	wuc
錈	wuc
銤	wud
鐏	wudg
鉼	wuf
钭	wufg
鉡	wuj
鎈	wujl
锎	wukf
镧	wuki
鏳	wumn
锏	wun
鐧	wun
镨	wunn
钔	wup
鍆	wup
锐	wuq
鋭	wuq
鐗	wuq
锵	wuqg
鎆	wuqn
鏻	wuqt
镁	wusy
鐥	wuub
	wuub
锑	wuvt
鎌	wuw
镒	wuwm
鉳	wux
錓	wux
镂	wuxk
鎙	wuxq
鎡	wuxx
镃	wuxx
食	wv
鈻	wv
鎷	wv
餞	wvaa
饇	wvab
鈱	wvag
鍲	wvan
饶	wvas
饯	wvat
镪	wvbl
馈	wvbm
鍏	wvbt
鐴	wvby
饲	wvcb
锔	wvcb
鋦	wvcb
飼	wvcb
饧	wvce
餺	wvdg
馎	wvdg
馇	wvdk
餔	wvdu
餰	wvei
饭	wvev
钮	wvf
鈕	wvf
锯	wvfb
饽	wvfc
馑	wvfh
飦	wvfl
饙	wvfm
饚	wvfm
餬	wvfq
馍	wvfs
馓	wvft
餀	wvfw
餝	wvfy
録	wvh
餦	wvha
饵	wvhd
饓	wvid
饣	wvii
饄	wvij
钃	wvil
饎	wvjb
鐞	wvjg
铎	wvjl
饁	wvjm
馌	wvjm
饒	wvjs
饐	wvju
鍜	wvjv
餗	wvki
飣	wvkl
饤	wvkl
馕	wvkq
鍨	wvks
镫	wvku
饨	wvkx
蚀	wvl
爭	wvl
蝕	wvl
鈏	wvl
鈟	wvl
銉	wvl
鏽	wvlr
饖	wvlt
镅	wvm
鎇	wvm
餇	wvmb
饥	wvmg
飷	wvmh
銿	wvmj
飿	wvmm
饳	wvmm
餶	wvmp
馉	wvmp
覶	wvmq
饠	wvmr
亂	wvmx
辭	wvmy
钯	wvn
鈀	wvn
餜	wvnd
馃	wvnd
餳	wvne
饆	wvnj
饂	wvnm
餵	wvnq
馒	wvnv
餲	wvnw
馄	wvnx
餤	wvoo
餆	wvoq
釲	wvp
餫	wvpa
餸	wvps
飶	wvpt
馆	wvpv
锓	wvpv
鋟	wvpv
館	wvpv
银	wvq
銀	wvq
飹	wvqc
馏	wvqn
馅	wvqr
馋	wvqu
饱	wvqv
饮	wvqw
饞	wvqy
鉘	wvr
饷	wvrb
餭	wvrh
镄	wvrm
餁	wvrt
餱	wvrt
馊	wvrv
餴	wvsf
餪	wvss
餣	wvsx
饿	wvta
鐍	wvtb
餎	wvtb
饹	wvtb
饬	wvtc
饩	wvtc
飭	wvtc
鍒	wvtd
餠	wvtf
饪	wvtj
飵	wvtl
饰	wvtm
饫	wvts
餼	wvtu
餧	wvtx
饍	wvub
饼	wvuf
餻	wvuo
馐	wvuv
铍	wvv
鈹	wvv
鎟	wvvd
鏺	wvvm
錣	wvvv
餟	wvvv
馔	wvvw
餄	wvwb
饸	wvwb
飻	wvwe
鈌	wvwg
飤	wvwg
餙	wvwm
餚	wvwq
饀	wvwr
馀	wvwt
餩	wvww
馁	wvwx
铌	wvx
鈮	wvx
饴	wvxb
餯	wvxs
餕	wvxt
馂	wvxt
饑	wvxw
钗	wvy
釵	wvy
鈬	wvy
餢	wvyb
餹	wvyb
飳	wvyh
饘	wvyk
飰	wvyl
餏	wvyq
饟	wvyq
饻	wvyq
饝	wvys
饺	wvyw
釟	ww
釡	ww
鍂	ww
谷	wwb
铪	wwb
鉿	wwb
谺	wwba
谽	wwbb
卻	wwbc
郤	wwbc
豂	wwbe
鑰	wwbf
谻	wwbj
谾	wwbj
螸	wwbl
豄	wwbm
慾	wwbp
欲	wwbq
鹆	wwbq
銳	wwbq
鵒	wwbq
豀	wwbs
豅	wwbs
豃	wwbt
谼	wwbw
鐱	wwbw
谹	wwbx
爷	wwc
鋢	wwck
鈖	wwco
铩	wwd
鎩	wwdm
鉁	wwe
斧	wwek
釜	wwfu
锊	wwgy
铨	wwh
銓	wwh
爺	wwhc
鉩	wwiw
锾	wwkv
錀	wwmf
鐇	wwn
鑁	wwot
铃	wwp
鈴	wwp
鑀	wwpt
鏭	wwpu
鍮	wwqn
爹	wwqq
镎	wwtg
鎐	wwtm
爸	wwvn
鑫	www
鋊	wwwb
锉	wwwj
鑯	wwwk
鎓	wwxc
鋖	wwxk
鍐	wwxt
鈆	wwxy
父	wwy
鋡	wwyb
鎗	wwyb
錜	wwyp
钤	wwyv
钆	wx
釓	wx
銯	wx
铷	wxb
鈶	wxb
銣	wxb
鑞	wxbx
镴	wxbx
翁	wxcc
鶲	wxcq
鹟	wxcq
枀	wxd
鐑	wxjb
妥	wxk
钕	wxk
釹	wxk
錄	wxki
鍿	wxkn
瓮	wxky
鎻	wxmw
鏆	wxmw
锱	wxnb
鏁	wxnd
忩	wxpu
兊	wxqg
鈗	wxqg
毤	wxqt
鵎	wxqx
鏘	wxsg
颂	wxsw
鉾	wxtl
	wxty
鉧	wxu
鋑	wxwt
乿	wxx
鈚	wxx
谿	wxxb
鑠	wxxd
鏒	wxxe
鷄	wxxq
锴	wxxr
奚	wxxs
鐖	wxxw
鎭	wxxw
公	wxy
鉯	wxyw
釯	wya
锫	wyb
錇	wyb
镐	wybb
錞	wybc
鍄	wybi
镶	wybq
锿	wybq
鎄	wybq
鑲	wybq
镦	wybt
钫	wyc
鈁	wyc
鎯	wyc
鑇	wycr
杀	wyd
弑	wydj
殺	wydm
刹	wydn
閷	wydw
锌	wyf
鋅	wyf
鏱	wyfg
鏣	wyfo
镀	wyfv
鑛	wyfw
鈫	wyg
鉒	wyh
乂	wyii
镝	wymf
钪	wymg
铈	wyml
刈	wyng
鐘	wynj
镳	wyow
鬯	wyox
鍗	wypm
镱	wypu
镑	wypy
铱	wyq
銥	wyq
镜	wyqg
铲	wys
郗	wysc
郄	wysc
郩	wysc
希	wysm
肴	wysq
欷	wysq
鵗	wysq
敎	wyst
鏟	wyst
瓻	wysy
鍦	wytc
镞	wytt
镟	wytv
鉝	wyu
镰	wyuw
锒	wyv
鋃	wyv
鎕	wyvb
鏮	wyvi
镛	wyvl
錊	wywf
爼	wywm
铰	wyww
爻	wywy
鏕	wyx
凶	wyxl
铳	wyxq
锍	wyxr
鏲	wyxt
铉	wyxx
鉱	wyxy
发	x
綫	xaat
緎	xabk
絾	xac
练	xaiw
絰	xaj
绖	xaj
缄	xakb
縅	xakx
縬	xali
绒	xas
絨	xas
绕	xasx
线	xat
繿	xatm
纜	xatq
緻	xatw
辔	xaxb
絗	xbb
絽	xbb
缲	xbbd
繟	xbbf
綑	xbd
絪	xbg
缉	xbhd
缋	xblm
縜	xbm
绳	xbnx
绢	xbq
絹	xbq
织	xbw
縕	xbwm
绍	xcb
紹	xcb
糿	xco
糼	xct
綎	xctj
綖	xctl
絕	xcvn
缪	xcwe
级	xcy
纫	xcy
紉	xcy
級	xcy
綛	xcyp
綝	xdd
絤	xdg
缚	xdgy
緸	xdj
缥	xdji
繧	xdjx
絊	xdk
綇	xdk
缃	xdm
緗	xdm
繐	xdpu
繻	xdsm
絉	xdy
绗	xeg
絎	xeg
紤	xek
縰	xell
縦	xeul
縱	xewl
缂	xff
緙	xff
綨	xfh
縙	xfhd
绀	xfj
紺	xfj
悳	xfmp
緓	xfms
绬	xfms
缜	xfmw
緢	xfnb
纎	xfnk
縸	xfns
繊	xfnu
綍	xfpc
纄	xfph
繱	xfqp
繖	xfqt
鸨	xfqx
駂	xfv
续	xfvs
绁	xfx
紲	xfx
緤	xfxd
雝	xgbr
邕	xgbv
巤	xgbx
巛	xgii
煭	xgko
甾	xgnb
勦	xgnc
鄛	xgnc
巢	xgnd
疀	xgnl
剿	xgnn
鶅	xgnq
災	xgow
絿	xgoy
纣	xgy
紂	xgy
绑	xhc
綁	xhc
绩	xhmw
綪	xhq
縥	xhtd
緅	xhvy
縤	xhx
匕	xi
纟	xiii
糸	xiii
乚	xiii
糹	xiii
绱	ximb
绡	xiq
綃	xiq
絒	xir
颍	xisw
絖	xisx
纱	xit
紗	xit
结	xjb
結	xjb
繥	xjbb
缬	xjbs
纬	xjc
絓	xjj
繞	xjjs
红	xjl
紅	xjl
續	xjmm
绪	xjn
緒	xjn
続	xjpq
綕	xjpu
頴	xjsw
颕	xjsw
緈	xjuj
繬	xjwb
纉	xjwm
绫	xjwt
纭	xjxy
緖	xjy
女	xk
姬	xka
姫	xka
嫗	xkab
嫟	xkab
娍	xkac
姪	xkaj
嫕	xkap
嬺	xkap
娆	xkas
姖	xkav
妪	xkaw
媙	xkax
如	xkb
嬠	xkbd
桇	xkbd
婟	xkbf
嬋	xkbf
姻	xkbg
綀	xkbi
妕	xkbl
娖	xkbl
媼	xkbm
嬇	xkbm
帤	xkbm
恕	xkbp
娟	xkbq
娱	xkbs
挐	xkbt
孍	xkbt
娲	xkbw
絮	xkbx
邚	xkc
婀	xkcb
娜	xkcc
嫪	xkce
好	xkck
她	xkcl
奶	xkcp
嫷	xkcq
嬥	xkcr
娗	xkct
嫥	xkdg
嫖	xkdj
孀	xkdm
嬬	xkds
婡	xkdw
婹	xkdx
嫮	xkdx
姤	xkeb
妡	xkek
娦	xkew
姑	xkfb
嫱	xkfb
婼	xkfb
媒	xkfd
娸	xkfh
媶	xkfh
嫤	xkfh
孏	xkfi
姏	xkfj
嬅	xkfj
嬞	xkfj
奸	xkfl
媾	xkfm
媌	xkfn
嬿	xkfo
娔	xkfq
媩	xkfq
孉	xkfr
嫫	xkfs
婻	xkfu
妓	xkfv
娂	xkfw
嫃	xkfw
嫨	xkfw
嫹	xkfw
婲	xkfx
媅	xkfx
嫴	xkfy
纡	xkg
紆	xkg
妦	xkhl
嫧	xkhm
媋	xkhn
婊	xkhq
婧	xkhq
嫀	xkht
娵	xkhv
嫊	xkhx
媣	xkid
嫦	xkim
娋	xkiq
姯	xkis
妙	xkit
嬯	xkja
嬉	xkjb
嬦	xkjg
妹	xkji
娃	xkjj
妅	xkjl
嬻	xkjm
媎	xkjn
娡	xkjp
妧	xkjq
媴	xkjq
妌	xkjr
嬈	xkjs
婈	xkjt
婞	xkju
嬄	xkju
妋	xkjw
姥	xkjx
妸	xkkb
娪	xkkb
妺	xkkd
妍	xkkf
娕	xkki
娻	xkki
婖	xkki
媡	xkki
娙	xkkj
姮	xkkk
婕	xkkl
姉	xkkm
嬾	xkkm
娅	xkkn
嫣	xkko
嫰	xkkq
妩	xkks
嫩	xkkt
姨	xkkw
婳	xkkx
孋	xkky
糽	xkl
婥	xklf
卐	xklk
絚	xklk
媫	xkll
婋	xklm
媜	xklm
嫭	xklu
婌	xklv
姛	xkmb
婤	xkmb
媧	xkmb
孈	xkmb
姍	xkmf
婩	xkmf
姐	xkmh
練	xkmi
姌	xkmj
姗	xkmk
姵	xkmm
媢	xkmm
嫼	xkmo
娊	xkmq
嬛	xkmq
姎	xkms
媏	xkms
嬽	xkms
媺	xkmt
嬍	xkmt
嬕	xkmu
妠	xkmw
婰	xkmw
奾	xkmx
孆	xkmx
緉	xkmy
纚	xkmy
娚	xknc
婐	xknd
婸	xkne
娨	xknf
婔	xknf
娌	xknj
缰	xknk
妲	xknk
絙	xknk
繮	xknk
妽	xknl
媞	xknl
媪	xknm
娼	xknn
缙	xknn
縉	xknn
妯	xkno
媤	xknp
媦	xknq
嫚	xknv
绠	xknw
娉	xknx
嫘	xknx
婫	xknx
嫐	xknx
媀	xkny
嬫	xkod
婒	xkoo
姚	xkoq
姹	xkpa
嫆	xkpb
婉	xkpc
媥	xkpf
婝	xkpg
婃	xkpj
媗	xkpk
嬣	xkpk
婶	xkpl
嬪	xkpm
妉	xkpq
嫁	xkps
妼	xkpt
妒	xkpv
嫔	xkpw
姲	xkpx
姁	xkqb
姳	xkqb
姽	xkqc
妳	xkqi
婙	xkql
媍	xkqm
婚	xkqn
娩	xkqq
嬎	xkqt
嬔	xkqt
婅	xkqu
媰	xkqx
嫓	xkqx
妁	xkqy
婣	xkr
姠	xkrb
媿	xkrb
媬	xkrd
婢	xkrf
媓	xkrh
婎	xkrl
婂	xkrm
嫶	xkro
媳	xkrp
婗	xkrq
嬶	xkrr
姙	xkrt
嬓	xkrt
嫂	xkrv
娰	xkrw
嬩	xkrw
嬹	xkrw
媲	xkrx
妬	xks
娝	xksb
婍	xksb
娏	xkse
媷	xksg
嫄	xksi
嫽	xksi
娠	xksj
妚	xksl
姷	xksq
媠	xksq
媆	xkss
姱	xksx
妭	xksy
娥	xkta
嬌	xktb
姀	xktd
奷	xktf
姓	xkth
姝	xkti
妊	xktj
娷	xktk
妰	xktl
姡	xktm
孂	xktm
娳	xktn
嫵	xkto
姂	xktp
姺	xktq
娇	xktr
妖	xkts
姊	xktt
妷	xktw
娒	xktx
婑	xktx
婾	xktx
嬟	xkua
嫸	xkub
婘	xkuc
娴	xkud
婵	xkuf
姘	xkuf
孄	xkui
姅	xkuj
嫅	xkuj
媊	xkun
媯	xkuo
嬨	xkup
娧	xkuq
嫺	xkuq
媄	xkus
嫉	xkut
娣	xkut
嫾	xkut
嫌	xkuw
妫	xkuy
妈	xkv
媽	xkv
姄	xkva
媉	xkva
努	xkvc
妤	xkvc
孥	xkvc
媃	xkvd
妞	xkvf
妇	xkvh
妃	xkvk
孎	xkvl
緁	xkvl
媚	xkvm
帑	xkvm
婦	xkvm
嬧	xkvm
妑	xkvn
怒	xkvp
婿	xkvq
砮	xkvs
娓	xkvt
嫋	xkvu
嬁	xkvu
弩	xkvv
驽	xkvv
娺	xkvv
婽	xkvv
駑	xkvv
胬	xkvw
妮	xkvx
奴	xkvy
姶	xkwb
娢	xkwb
妢	xkwc
娐	xkwc
嬆	xkwc
婇	xkwd
婨	xkwf
媕	xkwf
姾	xkwh
孅	xkwk
媮	xkwn
嬒	xkwn
嬏	xkwn
嬀	xkwo
姈	xkwp
妎	xkwr
嫍	xkwr
婬	xkwt
媱	xkwt
嬡	xkwt
媛	xkwv
嫒	xkwv
妗	xkwv
嬐	xkww
妐	xkwx
娞	xkwx
始	xkxb
姧	xkxf
經	xkxj
奻	xkxk
媸	xkxl
嬵	xkxm
姢	xkxq
媘	xkxr
娭	xkxt
姆	xkxu
姒	xkxw
纯	xkxx
妣	xkxx
姦	xkxx
純	xkxx
夨	xky
娮	xky
嬂	xkya
婄	xkyb
妨	xkyc
媇	xkyd
嫲	xkyd
嫡	xkyf
嫜	xkyf
妏	xkyg
妵	xkyh
婛	xkyi
嫝	xkyi
婷	xkyk
嬗	xkyk
嫞	xkyl
妔	xkym
媂	xkym
孊	xkyn
嫬	xkyo
嬑	xkyp
嬢	xkyq
孃	xkyq
嬚	xkyu
娘	xkyv
姣	xkyw
嬷	xkyx
嫎	xkyy
凵	xlii
屮	xlii
丩	xlii
丱	xlii
蚩	xlkl
旹	xlkn
妛	xlkx
緽	xlmw
绰	xlnf
纑	xlnm
雟	xlrb
爿	xls
戕	xlsa
牁	xlsb
牄	xlsb
牆	xlsb
槳	xlsd
牀	xlsd
牃	xlsd
醬	xlsd
斨	xlse
弉	xlsf
將	xlsg
漿	xlsi
墏	xlsj
壯	xlsj
牅	xlsl
螿	xlsl
焋	xlso
裝	xlsq
奘	xlss
牂	xlsu
銺	xlsw
妝	xlsx
娤	xlsx
孼	xltc
櫱	xltd
蠥	xltl
糱	xltu
收	xltw
辥	xlty
収	xlvy
紪	xlx
艸	xlxl
芔	xlxx
茻	xlxx
纲	xm
絅	xmb
繷	xmfs
组	xmh
組	xmh
缈	xmit
纆	xmj
绸	xmjb
繹	xmju
絧	xmkb
缳	xmkq
绌	xmm
絀	xmm
缨	xmmx
繉	xmoq
縎	xmp
絸	xmqg
繃	xmqq
纗	xmrb
繀	xmrl
紻	xmsy
綱	xmum
網	xmuy
緺	xmvb
綗	xmwb
纳	xmwg
郻	xmxc
纙	xmxr
旨	xn
细	xnb
細	xnb
綶	xnd
绯	xnf
緋	xnf
縪	xnfj
繓	xnhv
縨	xnis
缇	xnkl
綥	xnkr
绅	xnl
紳	xnl
緼	xnmn
缊	xnmn
缦	xnmv
縄	xnnx
纝	xnnx
紬	xno
	xno
缌	xnpu
緭	xnq
緆	xnqe
鴲	xnqx
缆	xntq
缧	xnx
縲	xnx
絏	xnxt
绲	xnxx
緪	xokk
縆	xokk
緂	xoow
絩	xoqg
熲	xosw
颎	xosw
緷	xpaf
縺	xpaf
缱	xpbv
缤	xpew
绽	xpg
綻	xpg
縖	xphb
综	xpji
綄	xpjq
繨	xpju
纻	xpk
縇	xpkk
紵	xpkl
繽	xpkm
縯	xpkw
编	xpmf
綩	xpqc
紞	xpqg
缩	xprn
綟	xpsu
綋	xpsx
缝	xpth
缒	xptv
繸	xpus
縌	xpux
绾	xpv
綰	xpv
紽	xpx
繩	xpx
縡	xpyf
纸	xqag
緍	xqan
絇	xqb
絻	xqbq
纔	xqby
繲	xqct
緫	xqep
紣	xqfg
縩	xqji
绚	xqn
絢	xqn
绷	xqq
綳	xqq
繎	xqso
綯	xqtm
绹	xqtm
绉	xqvh
绝	xqvn
繺	xqvo
縐	xqxx
约	xqy
纨	xqy
約	xqy
紈	xqy
紃	xr
緥	xrbd
綼	xrfg
紨	xrgy
缎	xrhm
線	xrio
缐	xrio
缏	xrkw
维	xrl
維	xrl
縧	xrld
绵	xrml
絈	xrn
纀	xrnu
絥	xrsu
絍	xrtj
總	xrtp
缑	xrvt
繌	xrwt
缴	xryt
缅	xsbj
缛	xsgy
绔	xsjx
绮	xskb
紑	xsl
纋	xsmt
絔	xsn
緾	xsnj
纒	xsnj
絠	xsq
縓	xsri
緛	xssy
紎	xsu
缭	xsui
绂	xsvy
顷	xsw
頃	xsw
綊	xsww
紌	xsx
紘	xsxy
纮	xsxy
乡	xt
络	xtb
絡	xtb
纥	xtcg
絁	xtcl
绣	xtcp
绦	xtd
纤	xtfg
缍	xtfk
鄊	xthc
綘	xthl
絑	xtiw
紝	xtj
纴	xtj
緟	xtkj
纁	xtko
蚃	xtl
绺	xtlb
絬	xtm
緮	xtnt
缵	xtqm
欵	xtqw
鄕	xtrc
繑	xtsb
颖	xtsw
绛	xttj
终	xtu
終	xtu
郷	xtvc
肄	xtvl
觺	xtvq
疑	xtvv
发	xtvy
紩	xtwg
飨	xtwv
緌	xtxk
兦	xty
嚮	xtyb
鄉	xtyc
蠁	xtyl
饗	xtyw
響	xtyy
母	xu
縂	xubp
绻	xuc
綣	xuc
毑	xucl
繜	xudg
緧	xudk
断	xuek
絣	xuf
紏	xufg
絴	xuh
毌	xuii
绊	xuj
絆	xuj
縒	xujl
缯	xumn
贯	xumw
綐	xuq
繝	xuq
繗	xuqt
絘	xuqw
毋	xus
缮	xuub
绨	xuvt
缣	xuw
縑	xuw
缢	xuwm
缕	xuxk
袰	xuyq
缗	xvan
繦	xvbl
緯	xvbt
纾	xvc
紓	xvc
纽	xvf
紐	xvf
绿	xvh
緑	xvh
经	xvj
経	xvj
繣	xvjk
绎	xvjl
縀	xvjv
纪	xvk
彑	xvk
紀	xvk
彙	xvkd
彝	xvkf
彔	xvki
剝	xvkn
彘	xvkx
紖	xvl
纼	xvl
繡	xvlr
紦	xvn
綅	xvpv
縃	xvq
绋	xvr
紼	xvr
彖	xvse
蠡	xvsl
盠	xvsm
剶	xvsn
劙	xvsn
鶨	xvsq
繘	xvtb
繍	xvur
紴	xvv
縔	xvvd
缀	xvvv
繏	xvvw
繈	xvxl
紭	xvxy
紁	xvy
给	xwb
給	xwb
綒	xwck
纷	xwco
綵	xwd
紾	xwe
絼	xwe
乆	xwg
亾	xwg
絟	xwh
绘	xwjx
缓	xwkv
綸	xwmf
繪	xwmn
繙	xwn
紷	xwp
绶	xwpv
緰	xwqn
紒	xwr
縚	xwrj
絺	xwsm
綌	xwwb
绤	xwwb
纵	xwwg
纖	xwwk
緃	xwwl
纶	xwx
绥	xwxk
総	xwxp
縘	xwxs
緵	xwxt
紟	xwyv
比	xx
糺	xx
絲	xx
绐	xxb
紿	xxb
緿	xxbp
幻	xxc
孧	xxcc
鴢	xxcq
幼	xxct
枈	xxd
毕	xxfg
坒	xxj
盭	xxjm
綠	xxki
毙	xxkx
纠	xxl
糾	xxl
鷆	xxmq
顚	xxms
眞	xxmw
缁	xxnb
缫	xxnd
毖	xxpt
鷥	xxqx
勓	xxrc
樂	xxrd
皆	xxrn
鶛	xxrq
匘	xxrw
缘	xxse
顈	xxsw
毞	xxta
继	xxud
纰	xxx
乣	xxx
紕	xxx
纅	xxxd
斷	xxxe
縿	xxxe
丝	xxxk
蠿	xxxl
幽	xxxm
畿	xxxn
鸶	xxxq
幾	xxxw
繼	xxxx
幺	xxy
纞	xxyp
姒	xxyw
乄	xy
以	xy
能	xy
織	xyat
台	xyb
缟	xybb
邰	xybc
枲	xybd
綡	xybi
繵	xybk
刣	xybn
炱	xybo
怠	xybp
綂	xybq
縗	xybq
纕	xybq
缞	xybq
乨	xybx
瓵	xyby
辝	xyby
纺	xyc
紡	xyc
纃	xycr
弁	xyf
鴘	xyfq
纊	xyfw
纹	xyg
紋	xyg
紸	xyh
厶	xyii
厼	xyiw
貟	xymw
贠	xymw
缠	xynj
繂	xyof
缔	xypm
繶	xypu
縍	xypy
能	xyq
允	xyqg
螚	xyql
熊	xyqo
態	xyqp
能	xyqx
緕	xyr
纩	xys
軬	xysa
参	xyse
叁	xysh
貵	xysm
畚	xysn
毵	xyst
奙	xysx
劺	xytc
牟	xytl
欸	xytq
鴾	xytq
矣	xyts
縼	xytv
以	xyw
綷	xywf
以	xywg
鵕	xywq
纐	xyws
夋	xywt
皴	xywv
绞	xyww
缡	xywx
	xyx
统	xyx
孿	xyxc
欒	xyxd
參	xyxe
卛	xyxf
斚	xyxf
叄	xyxh
叅	xyxi
灓	xyxi
垒	xyxj
蠻	xyxl
巒	xyxm
矕	xyxm
剼	xyxn
曫	xyxn
戀	xyxp
统	xyxq
奱	xyxs
攣	xyxt
毿	xyxt
縴	xyxt
變	xyxt
彎	xyxv
絯	xyxw
臠	xyxw
鑾	xyxw
厽	xyxx
孌	xyxx
絃	xyxx
絫	xyxx
厸	xyxy
絋	xyxy
度	y
亡	ya
諓	yaat
吂	yab
謳	yabb
赢	yaby
嬴	yaby
羸	yaby
蠃	yaby
臝	yaby
贏	yaby
驘	yaby
鸁	yaby
诚	yac
邙	yac
誠	yac
杗	yad
诫	yaf
誡	yaf
诓	yah
誆	yah
誈	yaj
试	yajl
諴	yakb
讶	yal
訝	yal
蝱	yall
盲	yam
朚	yanq
忘	yapu
肓	yaq
衺	yaq
望	yaqh
谮	yaqn
巟	yar
衁	yatm
讵	yav
詎	yav
氓	yava
讴	yawy
妄	yaxk
勯	ybbc
勷	ybbc
譟	ybbd
瓤	ybbe
譂	ybbf
禀	ybbj
亶	ybbk
襄	ybbq
颤	ybbs
氈	ybbt
稟	ybbt
讝	ybbt
皽	ybbv
谔	ybbx
亨	ybc
郭	ybcc
亸	ybcf
嚲	ybcf
塾	ybcj
享	ybck
熟	ybco
烹	ybco
憝	ybcp
鹑	ybcq
敦	ybct
鐜	ybcw
孰	ybcy
諿	ybhd
勍	ybic
蹵	ybil
剠	ybin
鹫	ybiq
就	ybis
京	ybiw
衰	ybkq
误	ybks
訲	ybl
衷	yblq
高	ybmb
鄗	ybmc
髝	ybmc
槀	ybmd
髞	ybmd
髜	ybmf
髚	ybmm
毃	ybmm
歊	ybmq
髛	ybmq
鶮	ybmq
稾	ybmt
敲	ybmv
亯	ybn
畗	ybnb
亳	ybpa
亭	ybpk
亮	ybpm
膏	ybpq
豪	ybps
毫	ybpt
哀	ybq
詋	ybqg
裛	ybvq
识	ybw
方	yc
词	ycb
诏	ycb
詔	ycb
詞	ycb
诩	ycc
邡	ycc
詡	ycc
旔	yccv
讯	ycfg
瓬	ycky
訑	ycl
鴋	ycqx
謵	ycrn
旑	ycsb
旖	yctb
施	yctc
旂	ycte
旗	yctf
旚	yctj
誔	yctj
旜	yctk
诞	yctl
旆	yctm
旝	yctn
旅	yctq
膂	yctq
旐	yctq
旓	yctq
鷟	yctq
旒	yctr
旞	ycts
族	yctt
旌	yctt
旄	yctt
旋	yctv
放	yctw
旎	yctx
旃	ycty
齋	ycui
韲	ycuk
齏	ycuk
齍	ycum
齎	ycum
劑	ycun
齌	ycuo
齊	ycur
乻	ycwc
谬	ycwe
旙	ycwn
讔	ycwp
斺	ycwr
於	ycwu
旕	ycwx
旀	ycxi
訒	ycy
訯	ycy
讱	ycy
旘	ycya
堃	ycyj
譅	ycyl
認	ycyp
旈	ycyr
諃	ydd
諲	ydj
謤	ydji
謣	ydjx
谭	ydnf
譓	ydpu
譳	ydsm
誧	ydu
誺	ydww
訹	ydy
诳	yeh
誑	yeh
訢	yek
	yek
诟	yekb
謕	yelm
诉	yey
訴	yey
辛	yf
诂	yfb
詁	yfb
谨	yfbh
讙	yfbr
辦	yfcy
辧	yfcy
谋	yfd
謀	yfd
瓣	yfey
諽	yff
计	yfg
計	yfg
諆	yfh
詌	yfj
讛	yfjx
辣	yfki
譁	yfkj
讦	yfl
訐	yfl
講	yfmj
謓	yfmw
諎	yfn
謿	yfnq
谟	yfns
譪	yfnw
誖	yfpc
護	yfrv
誮	yfrx
诺	yfsb
谳	yfsu
諵	yfu
讌	yfuo
	yfuo
辨	yfuy
读	yfvs
谌	yfx
乵	yfx
詍	yfx
諶	yfx
谍	yfxd
辫	yfxy
辡	yfyf
谎	yfyr
辩	yfyy
文	yg
吝	ygb
斈	ygck
彣	yge
対	yggy
斊	yghd
斌	ygkl
贇	ygkm
赟	ygkm
蚉	ygl
螡	ygll
斔	yglw
螤	yglw
斍	ygmq
刘	ygng
斒	ygpf
忞	ygpu
亵	ygqq
鳼	ygqx
鴍	ygqx
齐	ygr
斉	ygr
斎	ygrj
齑	ygrk
斖	ygrm
剂	ygrn
﨎	ygrv
斋	ygsm
斓	ygui
紊	ygx
讨	ygy
討	ygy
斏	ygyv
主	yh
讍	yhbb
誀	yhd
诪	yhgy
讘	yhhh
譿	yhhp
诔	yhi
誄	yhi
殶	yhmv
謮	yhmw
请	yhq
請	yhq
諘	yhq
謸	yhtw
诹	yhvy
言	yi
讠	yiii
丶	yiii
亠	yiii
乀	yiii
乁	yiii
訁	yiii
讜	yimo
昶	yin
誻	yin
譡	yinb
永	yio
氷	yio
谠	yip
诮	yiq
誚	yiq
詶	yir
訬	yit
诘	yjb
詰	yjb
譆	yjbb
讳	yjc
誟	yjck
诗	yjgy
诖	yjj
詿	yjj
譊	yjjs
讧	yjl
訌	yjl
讀	yjmm
讟	yjmy
诸	yjn
諸	yjn
読	yjpq
誌	yjpu
讲	yjr
譸	yjvg
讃	yjwm
譛	yjwn
褻	yjwq
诬	yjww
詓	yjxy
斌	ykal
诃	ykb
訶	ykb
謌	ykbb
誎	ykbi
諨	ykbn
訮	ykf
訏	ykg
订	ykl
訂	ykl
证	ykll
谏	ykmi
諌	ykni
詽	yksf
评	ykuk
语	ykvb
誱	ykvl
誙	ykxj
訰	ykxx
谑	ylak
詀	ylb
卞	ylg
讣	ylg
訃	ylg
让	ylk
讞	ylks
諔	ylkv
訨	yll
諕	ylmg
謯	ylmh
譃	ylnu
謼	yltu
訿	ylx
詗	ymb
诇	ymb
邟	ymc
劥	ymct
譨	ymfs
讥	ymg
亢	ymg
诅	ymh
詛	ymh
褱	ymiq
调	ymjb
譯	ymju
詷	ymkb
譞	ymkq
市	yml
诎	ymm
詘	ymm
訵	ymn
誢	ymqg
讗	ymrb
諯	ymsm
颃	ymsw
詇	ymsy
諷	ymtl
誷	ymuy
设	ymv
設	ymv
諣	ymvb
讷	ymwg
讽	ymwy
讪	ymx
訕	ymx
訉	ymy
音	yn
戠	ynat
亩	ynb
韻	ynbm
韶	yncb
课	ynd
課	ynd
裹	yndq
诽	ynf
誹	ynf
鄣	ynfc
彰	ynfe
章	ynfg
赣	ynfm
戆	ynfp
韺	ynfs
竷	ynft
頀	ynfv
亰	yniw
髙	ynjb
裏	ynjq
裏	ynjq
詚	ynk
諹	ynke
諟	ynkl
韴	ynkm
訷	ynl
韷	ynmm
谩	ynmv
誯	ynn
讄	ynnn
韼	ynph
鷾	ynpq
意	ynpu
谓	ynq
裵	ynq
謂	ynq
竟	ynqg
竸	ynqq
韵	ynqu
歆	ynqw
谒	ynqw
謁	ynqw
嬜	ynqx
鶕	ynqx
畝	ynqy
韹	ynrh
謃	ynth
韸	ynth
譵	ynug
畒	ynwg
谡	ynwt
畆	ynxy
谈	yoow
誂	yoqg
率	yoxf
诨	ypaf
讉	ypbm
谴	ypbv
謆	ypcc
﨤	ypcy
諚	ypg
誴	ypji
諠	ypkk
詝	ypkl
谝	ypmf
谊	ypmh
谉	ypnl
訦	ypqg
诧	ypta
谧	yptm
悥	ypu
訫	ypu
谜	ypud
譢	ypus
讅	ypwn
詑	ypx
譝	ypx
讁	ypyf
衣	yq
諙	yqan
诋	yqay
訽	yqb
詺	yqb
谗	yqbu
讒	yqby
裦	yqkq
褎	yqkq
褏	yqkq
襃	yqkq
裔	yqmb
讂	yqmt
询	yqn
詢	yqn
袌	yqq
袲	yqqq
誃	yqqy
谄	yqrj
诡	yqsc
谵	yqsy
訅	yqt
椉	yqtd
謋	yqtd
謠	yqtm
諊	yqud
诌	yqvh
诤	yqvl
詾	yqwx
謅	yqxx
訋	yqy
訙	yqy
训	yr
亣	yr
訓	yr
謉	yrb
褒	yrbq
諀	yrfg
谢	yrgy
諻	yrh
譭	yrjm
谁	yrl
誰	yrl
詯	yrm
亹	yrmm
亱	yrnk
谯	yrow
裒	yrq
褢	yrq
誽	yrqg
謥	yrtp
鵺	yrtq
夜	yrty
謏	yrvy
謢	yrvy
谀	yrwg
讹	yrx
訛	yrx
譤	yryt
广	ys
库	ysaf
庢	ysaj
庌	ysal
廤	ysax
邝	ysc
廖	ysce
庭	ysct
廕	yscx
床	ysd
麿	ysdb
麻	ysdd
塺	ysdj
庮	ysdk
廂	ysdm
黂	ysdm
靡	ysdn
爢	ysdo
魔	ysdr
磨	ysds
摩	ysdt
麾	ysdt
犘	ysdt
穈	ysdt
糜	ysdu
黀	ysdv
庲	ysdw
麽	ysdx
縻	ysdx
麼	ysdx
诼	yse
諑	yse
庍	ysek
鄺	ysfc
廝	ysfe
廑	ysfh
席	ysfm
庴	ysfn
庿	ysfn
剫	ysfn
庶	ysfo
懬	ysfp
鹧	ysfq
庋	ysfv
度	ysfv
庻	ysfw
廣	ysfw
庹	ysfy
庪	ysgv
廰	yshp
廳	yshp
廒	ysht
緳	yshx
应	ysik
廠	ysit
庄	ysj
誫	ysj
廧	ysjb
庨	ysjc
庤	ysjg
廚	ysjg
廅	ysjm
譇	ysjn
庱	ysjt
誇	ysjx
庒	ysjy
庁	yskl
庑	ysks
庉	yskx
廲	ysky
店	yslb
廬	yslm
庛	yslx
廁	ysmn
廮	ysmx
鄽	ysnc
廛	ysnj
庙	ysno
庘	ysnp
廙	ysnw
庽	ysny
庣	ysoq
诙	ysow
応	yspu
庐	yspv
詴	ysq
廫	ysqe
廇	ysqn
廨	ysqt
廯	ysqu
庖	ysqv
底	ysqy
噟	ysrb
廆	ysrb
庥	ysrd
庳	ysrf
府	ysrg
謜	ysri
螷	ysrl
蠯	ysrl
廏	ysrm
焤	ysro
應	ysrp
鹰	ysrq
膺	ysrq
鷹	ysrq
廋	ysrv
腐	ysrw
庾	ysrw
譍	ysry
庬	ysse
庞	ysst
庵	yssx
庆	yssy
讈	ystl
廭	ystm
廡	ysto
庝	ystu
庅	ystx
庰	ysuf
庠	ysuh
劆	ysun
廉	ysuw
廔	ysux
唐	ysvb
序	ysvc
康	ysvi
廜	ysvj
庸	ysvl
赓	ysvm
廃	ysvq
廐	ysvq
鶊	ysvq
鶶	ysvq
鷛	ysvq
鹒	ysvq
庚	ysvw
廦	ysvy
詙	ysvy
庺	yswd
庂	yswg
座	yswj
廥	yswn
廞	yswq
庎	yswr
庩	yswt
庈	yswv
庀	ysx
訧	ysx
廱	ysxr
庼	ysxs
廎	ysxs
庇	ysxx
废	ysxy
廊	ysyc
廓	ysyc
廍	ysyc
廪	ysyj
庡	ysyq
廩	ysyt
廘	ysyx
託	ytag
讬	ytag
誐	ytat
詻	ytb
讫	ytcg
诱	ytcp
訸	ytd
諈	ytfk
譕	ytfo
诛	ytiw
诰	ytj
誥	ytj
许	ytk
許	ytk
諥	ytkj
诈	ytlg
话	ytm
話	ytm
誗	ytng
诜	ytqg
讚	ytqm
謻	ytqq
譑	ytsb
訞	ytsy
譗	ytwb
詄	ytwg
袠	ytwq
诿	ytxk
诲	ytxu
立	yu
咅	yub
部	yubc
剖	yubn
竞	yubq
敨	yubt
郶	yubv
瓿	yuby
翊	yucc
亲	yud
詸	yud
新	yude
竱	yudg
譐	yudg
親	yudq
竎	yuf
誁	yuf
竍	yufg
攱	yufv
详	yuh
詳	yuh
靖	yuhq
竗	yuit
詊	yuj
竒	yukb
竦	yuki
谰	yuki
讕	yuki
竵	yuku
站	yulb
竨	yulf
商	yumb
啇	yumf
竌	yumg
颯	yuml
譄	yumn
歒	yumq
端	yums
敵	yumt
竐	yumv
飒	yumw
甋	yumy
勭	yunc
童	yunj
谱	yunn
氃	yunt
諩	yunu
竭	yunw
竜	yunx
啻	yupb
竚	yupk
帝	yupm
覫	yupq
鶙	yupq
竤	yupx
旁	yupy
说	yuq
説	yuq
譋	yuq
谘	yuqb
谫	yuqc
竫	yuql
讇	yuqr
鴗	yuqx
竧	yurh
产	yus
彦	yuse
竰	yusj
毅	yusm
剷	yusn
竡	yusn
颜	yuss
産	yust
亷	yusw
竑	yusx
竓	yuta
議	yuta
竏	yutf
竔	yutf
竬	yuty
竴	yuug
竲	yuun
竮	yuvf
竳	yuvu
谦	yuw
謙	yuw
竕	yuwc
谥	yuwm
竛	yuwp
妾	yuxk
竣	yuxt
暜	yuyn
竝	yuyu
良	yv
諱	yvbt
郒	yvbv
郎	yvc
郎	yvc
郞	yvc
勆	yvct
譀	yvht
译	yvjl
记	yvk
記	yvk
證	yvku
訠	yvl
诵	yvmj
誳	yvmm
剆	yvng
誋	yvpu
誛	yvpv
朗	yvq
褭	yvq
詪	yvq
諝	yvq
谞	yvq
塱	yvqj
欴	yvqw
谲	yvtb
袤	yvtq
詖	yvv
诐	yvv
諁	yvvv
譔	yvvw
诀	yvwg
訍	yvy
訳	yvy
謘	yvyf
誸	yvyx
六	yw
詥	ywb
讑	ywbf
兗	ywbq
袞	ywbq
說	ywbq
譣	ywbw
孪	ywck
訜	ywco
栾	ywd
诊	ywe
診	ywe
弈	ywf
认	ywg
诠	ywh
詮	ywh
諡	ywkm
谖	ywkv
蛮	ywl
論	ywmf
帟	ywml
譮	ywmn
脔	ywmw
峦	ywmx
譒	ywn
詅	ywp
恋	ywpu
谕	ywqn
鸾	ywqx
亦	ywr
謟	ywrj
彥	ywse
誵	ywsq
顏	ywss
產	ywst
奕	ywsy
挛	ywtg
谣	ywtm
譌	ywto
変	ywtw
弯	ywvx
变	ywvy
銮	yww
郊	ywwc
卒	ywwf
谶	ywwk
虠	ywwm
鵁	ywwq
䴔	ywwq
雜	ywwr
顇	ywws
頝	ywws
效	ywwt
交	ywwy
论	ywx
娈	ywxk
訩	ywxl
讻	ywxl
衮	ywxq
兖	ywxq
離	ywxr
謑	ywxs
离	ywxx
讼	ywxy
义	ywy
亪	ywy
誝	ywyb
謒	ywyb
谂	ywyp
訡	ywyv
鹿	yx
麙	yxab
诒	yxb
詒	yxb
袬	yxbq
麌	yxbs
麕	yxbt
麣	yxbt
鄜	yxc
麢	yxdb
麜	yxdd
弃	yxf
棄	yxfd
麒	yxfh
塵	yxj
麠	yxkk
廌	yxko
訆	yxl
麂	yxmg
麆	yxmh
夣	yxmq
謴	yxmw
诣	yxn
詣	yxn
麃	yxow
育	yxq
充	yxqg
麅	yxqv
麝	yxrg
壅	yxrj
雍	yxrl
麑	yxrq
罋	yxrt
饔	yxrw
甕	yxry
麎	yxsj
麔	yxtb
麇	yxtd
麘	yxtn
诶	yxts
譺	yxtv
麋	yxud
麟	yxut
麏	yxvb
麛	yxvh
慶	yxvt
麚	yxvv
詉	yxvy
詜	yxvy
鏖	yxw
劾	yxwc
亥	yxwg
賌	yxwm
刻	yxwn
欬	yxwq
詤	yxwr
颏	yxws
誜	yxwt
麀	yxx
詏	yxxc
鄐	yxxc
謲	yxxe
畜	yxxn
玈	yxxq
谐	yxxr
玅	yxxt
牽	yxxt
譏	yxxw
玆	yxxx
玄	yxxy
麐	yxyb
麞	yxyf
麈	yxyh
麖	yxyi
麍	yxyr
麡	yxyr
麤	yxyy
誩	yy
識	yyat
謞	yybb
谆	yybc
谅	yybi
諪	yybk
譠	yybk
讓	yybq
譹	yybs
譈	yybt
访	yyc
訪	yyc
謶	yyfo
註	yyh
詠	yyio
蠃	yyl
謪	yymb
谪	yymf
赢	yymw
谙	yyn
諳	yyn
臝	yynd
谛	yypm
譩	yypu
谤	yypy
鸁	yyqx
谚	yyse
羸	yyuh
譧	yyuw
誏	yyv
驘	yyv
谇	yywf
譲	yywq
詨	yyww
謧	yywx
议	yywy
嬴	yyxk
该	yyxw
詃	yyxx
譶	yyy
匭	aaqt
匱	ablm
贒	ablm
輯	afbh
軹	afbw
軺	afcb
軔	afcy
輔	afdu
槧	afed
塹	afej
斬	afek
暫	afen
鏨	afew
軲	affb
軒	affl
輳	afhs
輒	afhx
轅	afjq
軻	afkb
輻	afkn
鑋	afkw
軙	aflv
軓	afmy
輞	afmy
軸	afno
輥	afnx
轄	afpb
軌	afqt
軟	afqw
輢	afsb
軛	afsc
輅	aftb
轎	aftb
軤	aftu
軼	aftw
轔	afut
軽	afvj
輾	afvq
軫	afwe
輇	afwh
輸	afwn
轓	afwn
輜	afxn
輺	afxn
輽	afxn
轍	afyt
較	afyw
輆	afyw
轆	afyx
賾	ahmw
匸	aiii
鴉	alqx
刬	atng
煕	avow
鴎	awqx
貳	ayjm
鳶	ayqx
喿	bbbd
卾	bbjc
覨	bbjq
鶚	bbjq
顎	bbjs
別	bcng
噴	bffm
哱	bfpc
圓	bgbm
圚	bgbm
園	bgjq
嘖	bhmw
嗩	bimw
哣	bkbu
唖	bknu
啞	bknu
飸	bkxw
噦	blat
踲	blem
蹏	blem
躓	blem
躪	blfr
蹎	blfw
踙	blhv
踛	bljj
跿	bljw
踕	blkl
貴	blkm
踼	blne
蹐	bloq
躂	blpu
躥	blpx
躦	bltm
踡	bluc
躑	bluc
躢	bluc
跘	bluj
踫	blun
蹳	blvm
蹍	blvq
蹹	blwc
踰	blwn
蹱	blyj
躋	blyr
跡	blyw
勛	bmct
翤	bmfc
嚶	bmmx
哕	bmqy
喚	bqms
鵑	bqqx
唕	brfg
啀	bsjj
嘠	bsma
嚘	bsmt
嘍	buxk
嗂	bwtm
喲	bxqy
啍	bybc
噈	bybs
飁	ccrl
鷚	ccwq
翋	ccyu
騭	cliv
隨	cpsq
賀	ctbm
鴐	ctbq
駕	ctbv
蜑	ctll
楍	dbbb
橢	dcsq
標	ddji
橒	ddjx
榃	ddnb
槱	ddow
樮	ddow
楆	ddxk
栃	dekc
勡	dgjc
翲	dgjc
彯	dgje
賈	dgmw
釃	dkky
栜	dkmi
醳	dkmu
橿	dknk
枾	dktl
醗	dkvq
酻	dkwc
釂	dkwg
楨	dlmw
櫻	dmmx
梘	dmqg
霳	doct
霃	doiq
雲	dojx
霕	dojx
靍	dorq
鸖	dorq
顬	doss
霛	dovv
霽	doyr
靄	doyw
椑	drfg
柎	drgy
櫚	dubb
樓	duxk
桪	dvgy
桾	dvtb
來	dwwg
欎	dwwg
欝	dwwg
猌	dwws
礬	dwws
顂	dwws
麥	dwwt
麨	dwwt
麰	dwwt
麷	dwwu
枩	dwxy
椮	dxse
櫞	dxxs
梈	dybc
槨	dybc
楟	dybk
欀	dybq
櫧	dyjn
貭	efmw
徔	egfp
徳	egfp
憄	egfp
徍	egjj
徢	egkl
徰	egkl
忂	egmr
躗	egvl
躛	egvl
徦	egvv
勶	egyc
獺	ekbm
頎	eksw
褩	eumq
媻	eumx
縏	eumx
艭	eurv
艀	euwc
獇	euxx
猺	ewtm
獄	eysu
載	faaf
胾	famw
蕆	famw
蕥	farl
歡	fbbq
觀	fbbq
鸛	fbbq
顴	fbbs
蕚	fbbx
蕢	fblm
怘	fbpu
尅	fbqg
鴣	fbqx
茘	fccc
藮	fdro
藢	femt
葧	ffpc
蘜	ffqu
靮	ffqy
韂	ffqy
靫	ffvy
賁	fgfm
顛	fgms
幹	fgnf
	fgnf
鶾	fgnq
鵓	fgpq
攰	fgvc
鳷	fgvq
頍	fgvs
賫	fgwm
卙	fhxf
蓡	fivv
薓	fivv
蕍	fiwn
覯	fjmq
菫	fkbh
荊	fkfn
顢	fkms
荁	fknk
薑	fknk
鵲	fknq
鷬	fknq
黆	fknq
莄	fknw
薞	fkwv
貰	fkxm
頇	flsw
莧	fmqg
萈	fmqy
蕜	fnpu
鶓	fnqx
鄚	fnsc
驀	fnsv
謩	fnsy
	fpct
薳	fpjq
鸏	fpjq
鹲	fpjq
蔔	fqkn
苃	fsvy
薫	ftko
藺	furl
葁	fuxk
蔅	fuxk
蔞	fuxk
藪	fuxt
蕁	fvjg
蕭	fvlr
蕷	fvsw
葤	fxgy
葒	fxjl
蒓	fxkx
藴	fxnm
葯	fxqy
蔣	fxsg
藃	fybq
蘘	fybq
藹	fynw
莣	fypu
摶	gdgy
挬	gfpc
擏	gfqt
撹	gipq
擷	gjbs
攆	gjwa
摗	gkbq
攖	gmmx
揮	gpaf
摙	gpaf
揬	gpsu
換	gqms
搗	gqmx
搖	gqtm
抜	gsvy
扥	gtag
揷	gtfr
攢	gtqm
擱	gutb
摟	guxk
擻	guxt
撳	gwqw
捨	gwtm
摜	gxmw
抝	gxxc
揨	gybk
撁	gyxt
長	haii
镸	haii
髥	hamj
嶅	hctm
贅	hctm
鰲	hcto
驁	hctv
聵	hdbm
聇	hdkl
耼	hdmj
聹	hdpk
郰	hdvc
聧	hdvs
聡	hdwp
琺	hijx
瑣	himw
耬	hiux
幚	hlcm
艷	hlhv
責	hlmw
瓔	hmmx
現	hmqg
靚	hqmq
瓚	htqm
瑫	hwrj
漸	iaek
潰	iblm
澀	icyl
漙	idgy
渿	idji
灘	ifbr
漧	ifnc
瀻	ifnw
溹	ifpx
瀟	ifvr
漬	ihmw
濪	ihqv
鴻	ijqx
沄	ijxy
瀨	ikbm
灢	ikbq
沞	ikml
瀕	ilis
渉	ilit
湞	ilmw
測	imng
漼	imrl
灝	inys
乑	ioii
氺	ioii
灐	ioow
覚	ipmq
賞	ipmw
滘	ipwb
瀏	iqcn
渙	iqms
洑	irsu
淛	itmn
瀾	iuki
溬	iuxx
漲	ivha
尙	iwmb
蠽	iwrl
輝	iwsa
尡	iwsx
涻	iwtm
滛	iwtm
濰	ixrl
湪	ixse
涥	iybc
漷	iybc
渟	iybk
灜	iyby
瀍	iynj
湤	iytc
滸	iytk
渷	iywq
滾	iywq
澭	iyxr
頡	jbsw
壾	jbuv
敼	jbuv
皷	jbuv
鼔	jbuv
斄	jgiw
頑	jgqs
輦	jgwa
規	jgwq
鳺	jgwq
奊	jjxy
壃	jknk
埡	jknu
慐	jlmp
項	jlsw
覡	jlwq
鵐	jlwq
鹀	jlwq
殾	jnmv
煑	jnow
愨	jpkp
坈	jpmg
慤	jpmp
壷	jpnu
壺	jpnu
撀	jvmt
韾	jvmy
埓	jwgy
暬	jwjn
赩	jwqv
趏	jwtm
趲	jwtm
夌	jwtw
趃	jwtw
壈	jybt
鵡	kalq
賴	kbim
揧	kbit
櫜	kbld
蟗	kbll
嚢	kblq
疈	kbnn
郖	kbuc
頙	klsw
頂	klsw
棗	kmii
僰	kmiw
朿	kmiw
酈	kmyc
鸝	kmyq
麗	kmyy
恵	knpu
悪	knpu
惡	knpu
殞	kqbm
殨	kqbm
	kqbm
殢	kqfm
烮	kqno
鮤	kqno
鴷	kqnq
	kqnq
殥	kqpw
殙	kqqn
殤	kqte
殮	kqww
頬	kuss
頓	kxxs
虝	lame
歔	lanq
膚	lanq
覷	lanq
鸕	lanq
虛	lanu
蟎	lfmy
蠎	lfsf
鹺	lgbj
鹵	lgbo
覘	lgbq
敁	lgbv
鹶	lgbv
鹷	lgbw
鹸	lgbw
鹼	lgbw
禼	lgbx
惄	lgkp
敊	lgkv
貞	lgmw
壡	lgpj
亅	liii
蝲	lkbn
顰	llif
頻	llis
歩	llit
祡	llxj
眥	llxm
貲	llxm
蟕	llxq
鴜	llxq
姕	llxx
歶	llxy
蜆	lmqg
螻	luxk
齪	lwbl
齠	lwcb
齬	lwkb
齜	lwlx
齟	lwmh
齙	lwqv
齲	lwty
齷	lwva
齦	lwvq
齡	lwwp
鳳	mgkq
帳	mlha
幘	mlhm
幀	mllm
羇	mnfb
羃	mnfm
羈	mnfv
罒	mnii
睼	mnkl
罯	mnyn
罰	mnyn
黲	moxe
鶻	mpqx
骫	mpqy
髏	mpux
骹	mpyw
睳	msjj
鴦	msqx
鶪	msqx
	msqx
矙	muvt
賊	mwas
戝	mwat
賎	mwat
貺	mwbq
賻	mwdg
販	mwev
財	mwgt
賕	mwgy
賬	mwha
賭	mwjn
賦	mwkl
貼	mwlb
鸎	mwmq
鸚	mwmq
罌	mwmt
贁	mwmt
嬰	mwmx
賜	mwne
則	mwng
賧	mwoo
貯	mwpk
瞹	mwpt
鵙	mwqx
貾	mwqy
贍	mwqy
賑	mwsj
賄	mwsq
賂	mwtb
貶	mwtp
敗	mwtw
贈	mwun
賺	mwuw
睉	mwwj
賒	mwwj
貽	mwxb
賠	mwyb
賍	mwyj
賅	mwyw
賋	mwyw
嶃	mxae
嶄	mxae
崓	mxbf
屻	mxcy
岃	mxcy
岋	mxcy
巔	mxfs
亗	mxjg
崶	mxjg
嶹	mxjg
峿	mxkb
嵿	mxks
獃	mxks
顗	mxks
岼	mxku
豈	mxku
峝	mxmb
峴	mxmq
峀	mxno
岇	mxqc
峗	mxqc
峞	mxqc
翙	mxqc
岻	mxqy
嶦	mxqy
巉	mxqy
巂	mxrb
峚	mxsj
崕	mxsj
嶳	mxsj
顓	mxss
嶏	mxsv
屼	mxsx
峩	mxta
峯	mxth
岝	mxtl
岞	mxtl
峂	mxtu
嵳	mxuj
巙	mxut
峎	mxvq
嵶	mxvu
峆	mxwb
峇	mxwb
嵢	mxwb
崳	mxwn
嶓	mxwn
岺	mxwp
嶾	mxwp
嵚	mxwq
嶔	mxwq
嵏	mxwt
嵕	mxwt
岒	mxwv
嵈	mxwv
嵜	mxyb
嵣	mxyb
嵪	mxyb
﨑	mxyb
崺	mxyc
峷	mxyf
崒	mxyf
崪	mxyf
巐	mxyf
甼	nbkl
畧	nbtb
畻	nbuj
畍	nbwr
毘	nbxx
顆	ndsw
輩	nfaf
晄	nisx
昰	nkll
題	nkls
晀	noqg
鴨	npqx
焽	nqow
鶡	nqxq
鹖	nqxq
顥	nybs
慚	oaek
憒	oblm
憤	offm
忶	ojxy
懶	okbm
惻	omng
惲	opaf
慩	opaf
愡	oqep
憫	ouyg
焑	owbd
憸	owbw
熮	owce
燿	owcr
煠	owfd
烵	owfq
烡	owfw
焫	owfw
熯	owfw
熿	owfw
炣	owkb
炡	owkl
烔	owmb
烱	owmb
煱	owmb
熴	owmx
焺	ownf
燝	owni
煟	ownq
熶	ownv
爜	ownv
勞	owoc
熒	owoo
燚	owoo
炏	owow
鎣	owow
熍	owpb
焥	owpc
熓	owqo
煥	owqs
焷	owrf
燬	owrm
熜	owrp
煩	owsw
燆	owtb
炵	owtu
熂	owtu
燜	owup
燈	owvu
烚	owwb
焀	owwb
熗	owwb
烰	owwc
熻	owwc
燴	owwn
炂	owwx
煷	owym
忴	owyv
烺	owyv
熝	owyx
慣	oxmw
遺	pblm
賽	pgfm
弿	pgfv
騫	pgfv
寬	pgfy
鵍	pgjq
鶎	pgjq
寁	pgkl
鴧	pgmq
寔	pgnl
寜	pgpl
翝	pgsc
寵	pgst
宒	pgta
宎	pgts
額	pgts
寱	pgxd
迲	pjxy
邐	pkmy
鄆	ppac
軍	ppaf
運	ppaf
皸	ppav
鴆	ppqq
瓭	ppqy
鶴	pprq
蠭	pthl
褾	pudj
襶	pufw
褞	punm
裈	pupa
褌	pupa
褳	pupa
裪	puqt
襍	purd
襖	purs
袚	pusy
褈	putj
褨	puuj
襇	puun
裞	puuq
襉	puuq
褸	puux
褘	puvt
襈	puvw
褑	puwv
褲	puya
窚	pwac
窺	pwjq
窾	pwjq
鵼	pwjq
窛	pwjx
竃	pwjx
竅	pwrt
窂	pwtl
窶	pwux
逧	pwwb
祒	pycb
祮	pyjb
禎	pylm
視	pymq
禔	pynl
礿	pyqy
禲	pysy
祄	pywr
膩	qajm
鴟	qayq
鴝	qbqx
貿	qcmw
膞	qdgy
腷	qkbn
脰	qkbu
鲖	qkmb
鳉	qkug
鳚	qkvg
脻	qkvl
觔	qmct
觵	qmfw
觴	qmte
腟	qpaj
鵬	qqqx
匎	qsnx
鳩	qtqx
膢	quxk
勨	qvbc
酁	qvbc
鵵	qvbq
毚	qvby
奐	qvms
負	qvmw
亀	qvnx
甔	qvsy
腏	qvvv
鸌	qxfv
鳧	qxmg
鳬	qxmg
島	qxmx
鴕	qxpx
裊	qxyq
盌	qycm
鴛	qycq
臕	qyow
貸	ramw
魒	rbdj
鵯	rbfq
傳	rdgy
鵂	rdqx
僨	rffm
債	rhmw
輿	rjaw
毀	rjjm
爂	rjmo
伕	rjwg
鼦	rjxb
鼭	rjxg
鼺	rjxn
鼣	rjxs
鼫	rjxs
鼳	rjxs
鼵	rjxs
鼧	rjxx
鼴	rjxx
倆	rkmy
儷	rkmy
偵	rlmw
鷦	rloq
鋚	rltw
鎥	rltw
讎	rlyr
側	rmng
齁	rmnq
齉	rmnq
僈	rnmv
賃	rtmw
俬	rtxy
僂	ruxk
貨	rxmw
傾	rxsw
儃	rybk
儫	rybs
儲	ryjn
頋	scsw
豖	seii
礍	sfnw
磧	shmw
丆	siii
	siii
碋	smkb
厠	smng
硯	smqg
鴯	smqx
饜	snqw
厎	sqay
贋	srrm
龔	stfw
聾	sthd
厏	stlg
襲	styq
鷢	suxq
豗	sxse
鴮	syjq
夽	syjx
綔	syjx
鵸	sykq
奛	synq
鵪	synq
鷯	syuq
鵊	sywq
鷞	sywq
夾	syww
毴	tanf
簣	tblm
氬	tckn
秄	tdck
秙	tdfb
穔	tdfw
穡	tdjb
穯	tdjb
秱	tdmb
鵚	tdmq
稈	tdnf
鍫	tdow
穟	tdps
睝	tdqm
稝	tdqq
鵹	tdqq
錅	tdqw
籗	tdrl
嵆	tdsm
稪	tdtt
稵	tdux
秴	tdwb
秎	tdwc
稱	tdwm
秢	tdwp
穏	tdwp
穩	tdwp
稭	tdxr
瓾	tdxy
稖	tdyb
穣	tdyq
鵝	tgaq
鵞	tgaq
簀	thmw
壬	tjii
篫	tjmt
笎	tjqg
贊	tjqm
鵠	tjqx
籟	tkbm
毎	tkxu
緐	tkxx
牱	tlkb
犃	tlyb
筧	tmqg
鴰	tmqx
舚	tmqy
矲	tsmx
簍	tuxk
凅	ubfb
糐	uddg
粠	udfw
籿	udgy
粀	udkw
亃	udqx
鄭	udsc
粌	udvl
糔	udvl
糏	udvq
粰	udwc
糝	udxe
婁	udxk
籹	udxk
數	udxt
氀	udxt
癲	ufms
齹	uhjl
羙	uhow
羮	uhow
羑	uhqy
義	uhta
歚	uhuq
癩	ukbm
剏	ukfy
癅	uknn
並	uknu
瘂	uknu
痙	ukxj
愬	ukxp
蟞	umil
幣	umim
鼈	umip
龞	umip
撆	umit
癭	ummx
閾	upak
閭	upbb
闆	upbb
閫	upbd
鷴	updq
閧	upfw
闐	upfw
鬨	upfw
閉	upgt
聞	uphd
閆	uphg
閯	upit
闊	upit
閨	upjj
闔	upjm
闌	upki
闃	upms
閶	upnn
閘	upnp
悶	uppu
闥	uppu
閽	upqn
閻	upqr
閥	upra
鬩	uprq
閣	uptb
閗	upuf
鬦	upuf
闋	upvs
闈	upvt
闞	upvt
鬫	upvt
閃	upwg
閄	upwg
閿	upwv
閔	upyg
閚	upyu
閼	upyu
閬	upyv
閡	upyw
瘓	uqms
資	uqmw
瘻	uuxk
鵜	uvlq
疦	uvwg
鶼	uwqx
癡	uxtv
凉	uybi
癝	uybj
駆	vawy
駛	vbwy
預	vcsw
楘	vctd
嵍	vctm
矝	vctw
驃	vdji
屆	vdjx
羣	vhtu
饏	vhtw
驟	vhvi
驪	vkmy
騁	vnkx
騸	vpcc
騙	vpmf
巺	vpvw
騮	vqcn
駙	vrgy
驄	vrtp
騎	vskb
孹	vtbc
繴	vtbx
屜	vtex
屨	vtex
屆	vtjx
屭	vtmm
鶌	vtmq
鶥	vtmq
屢	vtux
騬	vtux
驥	vunw
驏	vvcc
頗	vvsw
騷	vvyl
駁	vwwy
張	vxha
費	vxrm
駿	vxwt
婱	vxyx
驤	vybq
勈	vymc
覌	vymq
鳮	vyqx
發	vyvm
欼	vyvq
歠	vyvq
鵽	vyvq
顙	vyvs
駭	vyxw
鋱	wapu
鍔	wbbx
翖	wbcc
錮	wbfb
銱	wbml
鴿	wbqx
龕	wbst
頜	wbsw
錒	wckb
貧	wcmw
頒	wcsw
鋌	wctj
鍵	wcvl
鏢	wdji
鐳	wdnb
鐔	wdnf
鏸	wdpu
鍁	weqw
貎	werq
鈑	wevy
鎮	wfmw
錨	wfnb
鏌	wfns
鋍	wfpc
鑊	wfrv
鍩	wfsb
舘	wgtv
仌	wgwg
韱	wgwk
睂	wgwm
倉	wgyb
盦	wgym
貪	wgym
欦	wgyq
飮	wgyq
鳹	wgyq
鶬	wgyq
頷	wgys
侌	wgyx
鍥	whcs
鋳	whgy
爫	wiii
釒	wiii
鎖	wimw
鑜	wimw
銬	wjkx
劎	wkbc
鋀	wkbu
鎘	wkbu
鉦	wkll
鈣	wklx
歈	wkqq
覦	wkqq
鈍	wkxx
鋤	wmct
銅	wmkb
鍘	wmng
覓	wmqg
鋧	wmqg
鐲	wmql
鈉	wmwg
鎉	wncc
鍀	wnkg
鏝	wnmv
鍶	wnpu
錫	wnqe
鏷	wnuh
錕	wnxx
錟	woow
銚	woqg
鍕	wpaf
鏈	wpaf
鑔	wpqj
鎵	wpse
領	wpsw
辤	wpvy
銨	wpxk
鎦	wqcn
鍃	wqep
鍯	wqep
鉚	wqtc
錚	wqvl
銫	wqvn
鈎	wqxy
鎸	wrcp
鍛	wrhm
錦	wrml
鎪	wrvy
錛	wsff
鈽	wsml
鐐	wsui
鐝	wsuq
鈸	wsvy
鋨	wtat
銹	wtcp
釺	wtfg
錘	wtfk
鍤	wtfr
鋒	wthl
銖	wtiw
銩	wtjx
鍾	wtkj
鍬	wtow
銑	wtqg
鷂	wtqx
鉄	wtwg
鈄	wufg
鐦	wukf
鑭	wuki
鐠	wunn
鎂	wusy
銻	wuvt
鎰	wuwm
鏤	wuxk
鏹	wvbl
饋	wvbm
餷	wvdk
飯	wvev
鋸	wvfb
餑	wvfc
饉	wvfh
饃	wvfs
饛	wvfs
饊	wvft
餌	wvhd
飠	wvii
饢	wvkq
鐙	wvku
餖	wvku
饾	wvku
飩	wvkx
飢	wvmg
饅	wvnv
餛	wvnx
餾	wvqn
餡	wvqr
飽	wvqv
飲	wvqw
飮	wvqw
餉	wvrb
餽	wvrb
鐨	wvrm
餿	wvrv
飥	wvta
餓	wvta
饦	wvta
飪	wvtj
飾	wvtm
餂	wvtm
饡	wvtm
飫	wvts
餅	wvuf
饈	wvuv
鐉	wvvw
饌	wvvw
餘	wvwt
餒	wvwx
飴	wvxb
餃	wvyw
鋝	wwgy
鍰	wwkv
鎿	wwtg
銼	wwwj
鈐	wwyv
勜	wxcc
錙	wxnb
頌	wxsw
鍇	wxxr
雞	wxxr
鎬	wybb
鐓	wybt
弒	wydj
剎	wydn
鍍	wyfv
鏑	wymf
鈧	wymg
鈰	wyml
鑣	wyow
鐿	wypu
鎊	wypy
鏡	wyqg
殽	wysm
鏃	wytt
鏇	wytv
鐮	wyuw
鏞	wyvl
鉸	wyww
兇	wyxq
銃	wyxq
錥	wyxq
鋶	wyxr
鉉	wyxx
緘	xakb
轡	xaxb
繰	xbbd
緝	xbhd
繢	xblm
繆	xcwe
縛	xdgy
縳	xdgy
縹	xdji
縝	xfmw
鴇	xfqx
巜	xgii
績	xhmw
緔	ximb
潁	xisw
纈	xjbs
綾	xjwt
紜	xjxy
紶	xjxy
娀	xkas
鴽	xkbq
娛	xkbs
娯	xkbw
妱	xkcb
娫	xkcl
恏	xkcp
媟	xkfd
媖	xkfs
嬳	xkfv
姞	xkjb
嬙	xkjb
妘	xkjx
姸	xkkf
奵	xkkl
姃	xkkl
娬	xkkl
婭	xkkn
嬭	xkkw
綆	xknw
媈	xkpa
嬘	xkps
婠	xkpv
嬸	xkpw
嫇	xkpw
姰	xkqn
媹	xkqn
嬼	xkqn
姼	xkqq
嬝	xkqq
奺	xkqy
婏	xkqy
孇	xkrv
娾	xksj
媔	xksj
奼	xkta
媑	xktj
姩	xktt
媨	xkud
嫻	xkud
婮	xkvf
娽	xkvh
嫿	xkvk
鴑	xkvq
媁	xkvt
拏	xkvt
妜	xkvw
娹	xkvx
緀	xkvx
嫏	xkyc
嫙	xkyv
姟	xkyw
妶	xkyx
嬤	xkyx
綽	xlnf
奬	xlss
狀	xlss
獎	xlss
緲	xmit
綢	xmjb
繯	xmkq
纓	xmmx
納	xmwg
緹	xnkl
縵	xnmv
緦	xnpu
緄	xnxx
繾	xpbv
綜	xpji
編	xpmf
縮	xprn
縫	xpth
縋	xptv
紙	xqag
絶	xqvn
緞	xrhm
緶	xrkw
綿	xrml
緱	xrvt
繳	xryt
緬	xsbj
縟	xsgy
絝	xsjx
綺	xskb
繚	xsui
紱	xsvy
紇	xtcg
綉	xtcp
綞	xtfk
綹	xtlb
纘	xtqm
穎	xtsw
絳	xttj
繒	xumn
貫	xumw
繕	xuub
綈	xuvt
縊	xuwm
縷	xuxk
緡	xvan
彜	xvkf
縁	xvse
綴	xvvv
紛	xwco
絵	xwjx
緩	xwkv
綬	xwpv
綏	xwxk
緇	xxnb
繅	xxnd
緣	xxse
粊	xxud
継	xxud
縞	xybb
綧	xybc
纏	xynj
締	xypm
熋	xyqo
鶭	xyqx
絞	xyww
縭	xywx
亝	xyxj
統	xyxq
鸞	xyxq
試	yajl
譖	yaqn
鸇	ybbq
鹯	ybbq
顫	ybbs
諤	ybbx
墪	ybcj
鶉	ybcq
撉	ybct
鶁	ybiq
鷲	ybiq
誤	ybks
亴	ybpq
稁	ybpt
訊	ycfg
斿	yctc
誕	yctl
斻	yctm
斾	yctm
旇	yctv
旍	yctw
旛	yctw
旟	yctw
膐	yctw
旊	ycty
謬	ycwe
譚	ydnf
詬	yekb
謹	yfbh
謨	yfns
諾	yfsb
諜	yfxd
辮	yfxy
謊	yfyr
辬	yfyy
辯	yfyy
剤	ygrn
斕	ygui
諏	yhvy
詩	yjgy
誣	yjww
証	ykll
諫	ykmi
評	ykuk
語	ykvb
謔	ylak
調	ymjb
頏	ymsw
訥	ymwg
贑	ynfm
贛	ynfm
戅	ynfp
戇	ynfp
謾	ynmv
恴	ynpu
諰	ynpu
謖	ynwt
談	yoow
諢	ypaf
謰	ypaf
譴	ypbv
諞	ypmf
誼	ypmh
詫	ypta
謐	yptm
謎	ypud
詆	yqay
諂	yqrj
詭	yqsc
譫	yqsy
諍	yqvl
詂	yrgy
謝	yrgy
譙	yrow
諛	yrwg
庫	ysaf
劘	ysdn
黁	ysdn
庯	ysdu
廗	ysfm
廟	ysfq
鷓	ysfq
詼	ysow
廀	yspv
廈	ysst
龐	ysst
鄌	ysvc
鄘	ysvc
廄	ysvm
廢	ysvm
賡	ysvm
広	ysxy
訖	ytcg
誘	ytcp
誅	ytiw
詐	ytlg
詵	ytqg
諉	ytxk
誨	ytxu
勏	yubc
競	yubq
譜	yunn
竩	yupm
竘	yuqb
諮	yuqb
謭	yuqc
譾	yuqc
豙	yuse
顔	yuss
顡	yuss
謚	yuwm
謱	yuxk
竢	yuxt
誦	yvmj
譎	yvtb
訣	yvwg
諼	ywkv
諭	ywqn
鵉	ywqx
謡	ywtm
効	ywwc
讖	ywwk
訤	ywwy
訟	ywxy
諗	ywyp
誒	yxts
郂	yxwc
頦	yxws
諧	yxxr
諄	yybc
諒	yybi
謫	yymf
贏	yymw
諦	yypm
謗	yypy
諺	yyse
誶	yywf
該	yyxw
